,date,paid to,item type,item name,artist,currency,item price,quantity,discount code,sub total,tax,shipping,ship from country name,transaction fee,fee type,item total,amount you received,bandcamp transaction id,paypal transaction id,assessed revenue share,collected revenue share,balance of revenue share,change to payout balance,payout balance,net amount,package,option,item url,sku,catalog number,upc,isrc,buyer name,buyer email,buyer phone,buyer note,ship to name,ship to street,ship to street 2,ship to city,ship to state,ship to zip,ship to country,ship to country code,ship date,ship notes,country,country code,region/state,city,referrer,referrer url
0,1/1/20 4:49am,Bandcamp,album,Sahel Sounds Label Sampler,Various Artists,USD,1.0,1.0,,1.0,,,,0.1,credit card,1.0,0.0,4078079163,,0.1,0.1,0.0,0.8,197.04,0.8,digital download,,http://sahelsounds.bandcamp.com/album/sahel-sounds-label-sampler,,SS-058,602318 137111,,Laura Mills,brownpatrick@gonzalez-edwards.com,325-694-2710x64200,,Tabitha Williams,163 Christopher Hollow Suite 031,,,,,,,,,United States,US,NY,Centereach,Recommendations footer: artist recommendation,bandcamp.com/footer/ar/a2285772157
1,1/1/20 1:35pm,Bandcamp,package,Eghass Malan,Les Filles de Illighadad,USD,12.0,1.0,,12.0,,4.0,United States,0.65,credit card,16.0,0.0,96221811,,1.2,1.2,0.0,14.15,211.19,10.15,'Eghass Malan' compact disc,,http://lesfillesdeillighadad.bandcamp.com/album/eghass-malan,SS-044cd-1,SS-044,191515 928351,,Richard Schultz,franklincarrie@hotmail.com,+1-971-463-3243x29858,,Jeff Sims,6544 Chambers Walks Apt. 502,,Hatfield,PA,19440,United States,US,1/7/20,,United States,US,PA,Hatfield,,
2,1/1/20 1:39pm,Bandcamp,album,Sahel Sounds Label Sampler,Various Artists,USD,1.0,1.0,,1.0,,,,0.1,credit card,1.0,0.0,425110236,,0.1,0.1,0.0,0.8,211.99,0.8,digital download,,http://sahelsounds.bandcamp.com/album/sahel-sounds-label-sampler,,SS-058,602318 137111,,John Freeman,walshricky@smith.com,(840)148-3280,,Jimmy Perez,07450 Alisha Stream,,,,,,,,,United States,US,PA,Perkasie,bandcamp.com,bandcamp.com
3,1/1/20 6:02pm,shop@sahelsounds.com,payout,,,USD,,,,,,,,1.21,transfer,120.62,119.41,t248046776,96E86811UH1789730,,,,-120.62,91.37,,,,,,,,,,,,,,,,,,,,,,,,,,,,
4,1/1/20 6:03pm,shop@sahelsounds.com,payout,,,USD,,,,,,,,0.24,transfer,23.6,23.36,t248046773,519496941R168554N,,,,-23.6,67.77,,,,,,,,,,,,,,,,,,,,,,,,,,,,
5,1/1/20 11:49pm,Bandcamp,package,Anou Malane,Abdallah Ag Oumbadougou,USD,8.0,1.0,,8.0,,14.0,United States,0.94,paypal,22.0,0.0,834045325,,0.8,0.8,0.0,20.26,88.03,6.26,Limited Edition Cassette,,http://abdallahagoumbadougou.bandcamp.com/album/anou-malane,SS-053cass,SS-053,602318 136992,,Rebekah Martin,williamslarry@ross-williams.org,+1-807-697-5030x905,,Kathryn Stokes,05610 Andersen Grove Apt. 175,,Abbotsford,VIC,3067,Australia,AU,1/7/20,,Australia,AU,VIC,Abbotsford,,
6,1/2/20 8:50am,Bandcamp,album,Unreleased Tapes 1981-1984,Mamman Sani,USD,7.0,1.0,,7.0,1.61,,,0.55,paypal,8.61,0.0,1069399304,,0.7,0.7,0.0,5.75,93.78,5.75,digital download,,http://mammansani.bandcamp.com/album/unreleased-tapes-1981-1984,,SS-030,889326 667568,,Anna George,phillipsdillon@hernandez.com,(771)973-7139,,Sharon Valentine,724 Jennifer Street,,,,,,,,,Ireland,IE,Leinster,Dublin,,
7,1/2/20 2:11pm,Bandcamp,album,Music from Saharan Cellphones,Various,USD,7.0,1.0,,7.0,1.33,,,0.54,paypal,8.33,0.0,185534597,,0.7,0.7,0.0,5.76,99.54,5.76,digital download,,http://sahelsounds.bandcamp.com/album/music-from-saharan-cellphones,,SS-003,889326 667889,,Maureen Smith,jeffreybarnes@hale.com,018-597-2205x786,,Raymond Patterson,631 Santiago Crescent,,,,,,,,,Spain,ES,Las Palmas,Puerto del Rosario,Google search,www.google.com/
8,1/2/20 2:22pm,Bandcamp,album,Ilana: The Creator,Mdou Moctar,USD,10.0,1.0,,10.0,,,,0.62,credit card,10.0,0.0,1783748474,,1.0,1.0,0.0,8.38,107.92,8.38,digital download,,http://mdoumoctar.bandcamp.com/album/ilana-the-creator,,SS-051,602318 136893,,Michael Lang,connorbrown@hotmail.com,382.219.1523x841,,Joanne Griffin,5545 Jennifer Parks Suite 561,,,,,,,,,Norway,NO,Innlandet,Hamar,,
9,1/2/20 2:57pm,Bandcamp,album,Ilana: The Creator,Mdou Moctar,USD,10.0,1.0,,10.0,,,,0.52,credit card,10.0,0.0,1355829645,,1.0,1.0,0.0,8.48,116.4,8.48,digital download,,http://mdoumoctar.bandcamp.com/album/ilana-the-creator,,SS-051,602318 136893,,Caitlyn Oneill,wendysantos@hotmail.com,(740)962-6439x0888,,Robert Jackson,500 Samuel Parks,,,,,,,,,United States,US,WI,Madison,,
10,1/2/20 4:47pm,Bandcamp,package,Ilana: The Creator,Mdou Moctar,USD,17.0,1.0,,17.0,,5.0,United States,0.78,credit card,22.0,0.0,1215634628,,1.7,1.7,0.0,19.52,135.92,14.52,Ilana LP,,http://mdoumoctar.bandcamp.com/album/ilana-the-creator,SS-051lp,SS-051,602318 136893,,Jose Hall,lchan@hotmail.com,873.509.3326x0011,,Ann Curry,26886 Morris Locks,,Edgewater,CO,80214,United States,US,1/7/20,,United States,US,CO,Edgewater,Google search,www.google.com/
11,1/2/20 6:02pm,shop@sahelsounds.com,payout,,,USD,,,,,,,,0.6,transfer,60.27,59.67,t248268544,3JH890996G8964929,,,,-60.27,75.65,,,,,,,,,,,,,,,,,,,,,,,,,,,,
12,1/2/20 6:02pm,shop@sahelsounds.com,payout,,,USD,,,,,,,,0.08,transfer,7.5,7.42,t248268545,2PC96109MF496504P,,,,-7.5,68.15,,,,,,,,,,,,,,,,,,,,,,,,,,,,
13,1/2/20 7:05pm,Bandcamp,album,Houmeissa,Hama,USD,20.0,1.0,,20.0,,,,0.74,credit card,20.0,0.0,2298748824,,2.0,2.0,0.0,17.26,85.41,17.26,digital download,,http://hamasynth.bandcamp.com/album/houmeissa,,SS-049,656605 382364,,Heidi Robinson,zsmith@hotmail.com,280-484-1554,,Todd Guerra,07212 Janice Loop,,,,,,,,,United States,US,WA,Seattle,Bandcamp search,bandcamp.com/app/ios/search
14,1/2/20 9:27pm,Bandcamp,package,Music from Saharan Cellphones: Volume 2,Various,USD,17.0,1.0,,17.0,,5.0,United States,0.72,paypal,22.0,0.0,2546278371,,1.7,1.7,0.0,19.58,104.99,14.58,Vinyl Edition of Music from Saharan Cellphones Volume 2,,http://sahelsounds.bandcamp.com/album/music-from-saharan-cellphones-volume-2,SS-012lp,SS-012,889326 667742,,Robert Castro,melissa77@summers-powers.biz,957.172.4976x0447,,Tasha Short,962 Craig Lane,,garner,NC,27529,United States,US,1/7/20,,United States,US,NC,garner,,
15,1/3/20 6:03pm,shop@sahelsounds.com,payout,,,USD,,,,,,,,0.68,transfer,68.15,67.47,t248506310,2F656360U34360258,,,,-68.15,36.84,,,,,,,,,,,,,,,,,,,,,,,,,,,,
16,1/3/20 7:56pm,Bandcamp,album,Music from Saharan Cellphones,Various,USD,7.0,1.0,,7.0,,,,0.4,paypal,7.0,0.0,2217721062,,0.7,0.7,0.0,5.9,42.74,5.9,digital download,,http://sahelsounds.bandcamp.com/album/music-from-saharan-cellphones,,SS-003,889326 667889,,Sandra Lynch,ctaylor@hotmail.com,(378)419-1720x8629,,Bill Tate,26055 Perez Ports,,,,,,,,,United States,US,OR,Portland,,
17,1/3/20 10:06pm,Bandcamp,album,Les Filles de Illighadad,Les Filles de Illighadad,USD,7.0,1.0,,7.0,,,,0.4,paypal,7.0,0.0,3240632352,,0.7,0.7,0.0,5.9,48.64,5.9,digital download,,http://lesfillesdeillighadad.bandcamp.com/album/les-filles-de-illighadad,,SS-033,889326 664918,,Tiffany Davis,davieslawrence@hester.net,193-183-1808x19784,,Abigail Riggs,1004 Cooke Motorway,,,,,,,,,United States,US,NY,Nanuet,Bandcamp search: “les filles”,bandcamp.com/search?q=les%20filles
18,1/4/20 1:14am,Bandcamp,album,Music from Saharan Cellphones,Various,USD,7.0,1.0,,7.0,,,,0.4,credit card,7.0,0.0,893874145,,0.7,0.7,0.0,5.9,54.54,5.9,digital download,,http://sahelsounds.bandcamp.com/album/music-from-saharan-cellphones,,SS-003,889326 667889,,Barry Schmitt,jennifercarroll@duran.com,(250)155-2990,,Patricia Tanner,438 Rogers Forges Suite 030,,,,,,,,,United States,US,IL,Belleville,,
19,1/4/20 2:33am,Bandcamp,album,Sahel Sounds Label Sampler,Various Artists,USD,1.0,1.0,,1.0,,,,0.1,credit card,1.0,0.0,4276172906,,0.1,0.1,0.0,0.8,55.34,0.8,digital download,,http://sahelsounds.bandcamp.com/album/sahel-sounds-label-sampler,,SS-058,602318 137111,,Jesus Stone,leegary@hernandez-carr.com,001-795-545-0593x0052,,Kevin Duke,061 Ruth Ferry,,,,,,,,,United States,US,CT,Stamford,Bandcamp artist: sahelsounds,sahelsounds.bandcamp.com/album/music-from-saharan-cellphones-volume-2
20,1/4/20 11:04am,Bandcamp,album,Houmeissa,Hama,USD,7.0,1.0,,7.0,,,,0.4,paypal,7.0,0.0,1734504905,,0.7,0.7,0.0,5.9,61.24,5.9,digital download,,http://hamasynth.bandcamp.com/album/houmeissa,,SS-049,656605 382364,,Gregory Hernandez,brittneywilliams@gmail.com,(233)987-2531x44475,,Jonathan Chen,4475 Wendy Track Suite 366,,,,,,,,,United States,US,NJ,Somerville,,
21,1/4/20 3:47pm,Bandcamp,album,Ilana: The Creator,Mdou Moctar,USD,7.0,1.0,,7.0,1.4,,,0.54,paypal,8.4,0.0,1624271293,,0.7,0.7,0.0,5.76,67.0,5.76,digital download,,http://mdoumoctar.bandcamp.com/album/ilana-the-creator,,SS-051,602318 136893,,Dawn Grimes,romandarrell@bowers-wade.biz,5470329581,,Linda Meyer,92753 Matthew Orchard Suite 825,,,,,,,,,United Kingdom,GB,Bristol,Bristol,rateyourmusic.com,rateyourmusic.com/release/album/mdou-moctar/ilana-the-creator/
22,1/4/20 6:03pm,shop@sahelsounds.com,payout,,,USD,,,,,,,,0.37,transfer,36.84,36.47,t248785974,9JL54016ES172881V,,,,-36.84,30.16,,,,,,,,,,,,,,,,,,,,,,,,,,,,
23,1/4/20 7:48pm,Bandcamp,album,Ilana: The Creator,Mdou Moctar,USD,7.0,1.0,,7.0,,,,0.4,credit card,7.0,0.0,3270726597,,0.7,0.7,0.0,5.9,36.06,5.9,digital download,,http://mdoumoctar.bandcamp.com/album/ilana-the-creator,,SS-051,602318 136893,,Emily Miller,judith79@yahoo.com,216.301.7465x8306,,Andrew Morton,192 Karen Ways Apt. 265,,,,,,,,,United States,US,CA,Hercules,Bandcamp search,bandcamp.com/autocomplete-search
24,1/4/20 7:52pm,Bandcamp,package,Anou Malane,Abdallah Ag Oumbadougou,USD,10.0,1.0,,10.0,,4.0,United States,0.61,credit card,14.0,0.0,2489423601,,1.0,1.0,0.0,12.39,48.45,8.39,Limited Edition Cassette,,http://abdallahagoumbadougou.bandcamp.com/album/anou-malane,SS-053cass,SS-053,602318 136992,,Jeffrey Jacobs,robinsonvincent@gmail.com,001-931-629-0984x148,,Gregory Miller,642 William Crossroad,,New York,NY,10009,United States,US,1/7/20,,United States,US,NY,New York,Google search,www.google.com/
25,1/4/20 8:15pm,Bandcamp,album,Anou Malane,Abdallah Ag Oumbadougou,USD,7.0,1.0,,7.0,,,,0.4,gift card,7.0,0.0,296854418,,0.7,0.7,0.0,5.9,54.35,5.9,digital download,,http://abdallahagoumbadougou.bandcamp.com/album/anou-malane,,SS-053,602318 136992,,Ryan Green,oneillryan@hotmail.com,6370394617,,Paul Whitaker,054 Angela Loop,,,,,,,,,United States,US,IL,Chicago,,
26,1/4/20 10:23pm,Bandcamp,package,Sahel Sounds Label Sampler,Various Artists,USD,20.0,1.0,,20.0,,5.0,United States,0.78,paypal,25.0,0.0,3970625947,,2.0,2.0,0.0,22.22,76.57,17.22,Sahel Sounds t-shirt,XL,http://sahelsounds.bandcamp.com/merch/sahel-sounds-t-shirt,SS-T01-BLK-UXL,,,,Daniel French,molly22@hotmail.com,075-389-8485x8610,,Jennifer Carter,30665 Carlos Alley,Suite 103 - Box 346,Tempe,AZ,85284,United States,US,1/7/20,,United States,US,AZ,Tempe,Bandcamp search,bandcamp.com/autocomplete-search
27,1/5/20 1:56am,Bandcamp,album,Music from Saharan Cellphones,Various,USD,7.0,1.0,,7.0,,,,0.47,paypal,7.0,0.0,1968743040,,0.7,0.7,0.0,5.83,82.4,5.83,digital download,,http://sahelsounds.bandcamp.com/album/music-from-saharan-cellphones,,SS-003,889326 667889,,James Riddle,christian43@johnson.net,+1-916-973-6786,,Tiffany Hansen,1345 Bryant Garden,,,,,,,,,Australia,AU,NSW,Sydney,,
28,1/5/20 3:57am,Bandcamp,album,La Musique Electronique du Niger,Mamman Sani,USD,7.0,1.0,,7.0,,,,0.47,credit card,7.0,0.0,251252605,,0.7,0.7,0.0,5.83,88.23,5.83,digital download,,http://mammansani.bandcamp.com/album/la-musique-electronique-du-niger,,SS-011,889326 664864,,Timothy Gallagher,john70@ortiz.biz,+1-568-899-4824,,Ashley Fisher,6641 Mcdowell Club Suite 269,,,,,,,,,Canada,CA,BC,Vancouver,Bandcamp Discover,bandcamp.com/#discover
29,1/5/20 4:01am,Bandcamp,album,Ilana: The Creator,Mdou Moctar,USD,7.0,1.0,,7.0,1.4,,,0.54,paypal,8.4,0.0,1132723532,,0.7,0.7,0.0,5.76,93.99,5.76,digital download,,http://mdoumoctar.bandcamp.com/album/ilana-the-creator,,SS-051,602318 136893,,David Brown,dsalazar@hotmail.com,293-596-8955x94051,,Richard Boone,74004 Williams Hollow,,,,,,,,,United Kingdom,GB,East Sussex,Seaford,Bandcamp home page,bandcamp.com/
30,1/5/20 4:14am,Bandcamp,album,Unreleased Tapes 1981-1984,Mamman Sani,USD,7.0,1.0,,7.0,,,,0.47,credit card,7.0,0.0,2551805403,,0.7,0.7,0.0,5.83,99.82,5.83,digital download,,http://mammansani.bandcamp.com/album/unreleased-tapes-1981-1984,,SS-030,889326 667568,,Christopher Wood,andrew34@gonzales.com,+1-602-303-5473x94861,,Emily Browning,383 Hamilton Mill Apt. 489,,,,,,,,,Australia,AU,NSW,Sydney,,
31,1/5/20 7:03am,Bandcamp,album,Ilana: The Creator,Mdou Moctar,USD,7.0,1.0,,7.0,,,,0.4,paypal,7.0,0.0,1423359174,,0.7,0.7,0.0,5.9,105.72,5.9,digital download,,http://mdoumoctar.bandcamp.com/album/ilana-the-creator,,SS-051,602318 136893,,Christopher Gibson,catherinefuentes@yahoo.com,130-481-9654x80995,,Alexander Gonzales,31973 Megan Crescent Apt. 191,,,,,,,,,United States,US,NY,Brooklyn,Bandcamp Daily: mdou-moctar-ilana-the-creator-review,daily.bandcamp.com/album-of-the-day/mdou-moctar-ilana-the-creator-review
32,1/5/20 10:31am,Bandcamp,album,Ilana: The Creator,Mdou Moctar,USD,7.0,1.0,,7.0,1.33,,,0.54,paypal,8.33,0.0,3892489014,,0.7,0.7,0.0,5.76,111.48,5.76,digital download,,http://mdoumoctar.bandcamp.com/album/ilana-the-creator,,SS-051,602318 136893,,Nicole Richardson,martinkristine@smith-wilson.com,(841)219-1701,,Mark Williamson,82669 Christopher Common,,,,,,,,,Germany,DE,Bavaria,Munich,,
33,1/5/20 11:44am,Bandcamp,album,Anou Malane,Abdallah Ag Oumbadougou,USD,30.0,1.0,,30.0,1.4,,,1.21,paypal,31.4,0.0,3616979343,,3.0,3.0,0.0,25.79,137.27,25.79,digital download,,http://abdallahagoumbadougou.bandcamp.com/album/anou-malane,,SS-053,602318 136992,,Mark Kim,denise39@chavez.info,7375756361,,Francisco Cunningham,210 David Crescent,,,,,,,,,United Kingdom,GB,,,,
34,1/5/20 1:16pm,Bandcamp,package,Anou Malane,Abdallah Ag Oumbadougou,USD,17.0,2.0,,34.0,,24.0,United States,2.16,credit card,58.0,0.0,2058287163,,3.4,3.4,0.0,52.44,189.71,28.44,Vinyl,,http://abdallahagoumbadougou.bandcamp.com/album/anou-malane,SS-053lp,SS-053,602318 136992,,Mitchell Forbes,michael94@ferguson.com,258-272-9408x1384,,Jessica Lozano,43583 Sanders Ferry,Kelmarsh,Northants,,NN6 9NA,United Kingdom,GB,1/7/20,,United Kingdom,GB,,Northants,Google search,www.google.co.uk/
35,1/5/20 3:42pm,Bandcamp,package,Ilana: The Creator,Mdou Moctar,USD,17.0,1.0,,17.0,,5.0,United States,0.72,paypal,22.0,0.0,4211577311,,1.7,1.7,0.0,19.58,209.29,14.58,Ilana LP,,http://mdoumoctar.bandcamp.com/album/ilana-the-creator,SS-051lp,SS-051,602318 136893,,Maria Nelson,zharmon@james.com,2290878188,,Betty Padilla,4849 Fry Streets,,West Deptford,NJ,8086,United States,US,1/7/20,,United States,US,NJ,West Deptford,Google search,www.google.com/
36,1/5/20 3:46pm,Bandcamp,package,Uchronia – Field Recordings From Alternate Realities,Sahel Sounds,USD,7.0,1.0,,7.0,,20.0,United States,1.16,credit card,27.0,0.0,3167999794,,0.7,0.7,0.0,25.14,234.43,5.14,Uchronia – Field Recordings From Alternate Realities photo book,,http://sahelsounds.bandcamp.com/merch/uchronia-field-recordings-from-alternate-realities-photo-book,SS-000book,,,,John Morris,sean67@davis-howard.com,001-547-409-1013x37580,,Faith Dalton,55232 Rachel Island,,Callaghan,NSW,2308,Australia,AU,1/7/20,,Australia,AU,NSW,Callaghan,Bandcamp fan wishlist,bandcamp.com/felix_gif
37,1/5/20 6:02pm,shop@sahelsounds.com,payout,,,USD,,,,,,,,0.24,transfer,24.4,24.16,t249000674,4R647661XM4137056,,,,-24.4,210.03,,,,,,,,,,,,,,,,,,,,,,,,,,,,
38,1/5/20 6:02pm,shop@sahelsounds.com,payout,,,USD,,,,,,,,0.06,transfer,5.76,5.7,t249000677,3SF40137MC358843L,,,,-5.76,204.27,,,,,,,,,,,,,,,,,,,,,,,,,,,,
39,1/5/20 8:24pm,Bandcamp,album,Abba Gargando,Abba Gargando,USD,7.0,1.0,,7.0,1.4,,,0.54,paypal,8.4,0.0,1667253191,,0.7,0.7,0.0,5.76,210.03,5.76,digital download,,http://abbagargando.bandcamp.com/album/abba-gargando,,SS-029,889326 664888,,Jessica Bishop,jeremytran@shannon.net,001-148-370-3072x40812,,Wendy Houston,4443 Scott Mountain Apt. 830,,,,,,,,,United Kingdom,GB,Nottingham,Nottingham,Bandcamp fan wishlist,bandcamp.com/christree1977
40,1/5/20 11:28pm,Bandcamp,package,Akounak Tedalat Taha Tazoughai OST,Mdou Moctar,USD,17.0,1.0,,17.0,,5.0,United States,1.08,paypal,22.0,0.0,1937430143,,1.7,0.0,1.7,0.0,210.03,14.22,Akounak OST LP,,http://mdoumoctar.bandcamp.com/album/akounak-tedalat-taha-tazoughai-ost,SS-028lp-1,SS-028,889326 667599,,Keith Rivera,moorejoshua@green.com,+1-937-814-5816,,Sarah Anderson,70191 Ryan Locks Suite 418,,santa fe,NM,87592,United States,US,1/7/20,,United States,US,NM,santa fe,duckduckgo.com,duckduckgo.com/
41,1/5/20 11:28pm,Bandcamp,package,Afelan,Mdou Moctar,USD,17.0,1.0,,17.0,,2.0,United States,,,19.0,0.0,1937430143,,1.7,3.4,0.0,36.52,246.55,15.3,Afelan LP,,http://mdoumoctar.bandcamp.com/album/afelan,SS-017lp,SS-017,889326 664840,,Brian Newton,jimmy52@yahoo.com,001-610-018-8731x7556,,Jennifer Robinson,1520 Silva Ridge,,santa fe,NM,87592,United States,US,1/7/20,,United States,US,NM,santa fe,duckduckgo.com,duckduckgo.com/
42,1/6/20 1:39am,Bandcamp,album,Eghass Malan,Les Filles de Illighadad,USD,7.0,1.0,,7.0,,,,0.47,credit card,7.0,0.0,3179361040,,0.7,0.7,0.0,5.83,252.38,5.83,digital download,,http://lesfillesdeillighadad.bandcamp.com/album/eghass-malan,,SS-044,191515 928351,,Allison Wells,jduffy@gmail.com,001-269-493-0075x836,,Linda Lee,15556 Peck Course,,,,,,,,,Australia,AU,VIC,Melbourne,Recommendations footer: artist recommendation,bandcamp.com/footer/ar/a3681570634
43,1/6/20 3:23am,Bandcamp,album,Eghass Malan,Les Filles de Illighadad,USD,7.0,1.0,,7.0,,,,0.4,credit card,7.0,0.0,2396847132,,0.7,0.7,0.0,5.9,258.28,5.9,digital download,,http://lesfillesdeillighadad.bandcamp.com/album/eghass-malan,,SS-044,191515 928351,,Jerry Smith,marissatate@yahoo.com,603.136.6190,,Kristen Newman,49638 Rodriguez Pines,,,,,,,,,United States,US,CA,Los Gatos,,
44,1/6/20 5:24am,Bandcamp,album,Houmeissa,Hama,USD,7.0,1.0,,7.0,,,,0.4,paypal,7.0,0.0,1533809260,,0.7,0.7,0.0,5.9,264.18,5.9,digital download,,http://hamasynth.bandcamp.com/album/houmeissa,,SS-049,656605 382364,,Joseph Petty,osbornekevin@gmail.com,+1-819-899-2103x46667,,Jennifer Willis,45603 Justin Parks Apt. 007,,,,,,,,,United States,US,VA,Ashburn,Bandcamp Daily (embedded player): bandcamp-essential-releases-january-18-2018,daily.bandcamp.com/2019/01/18/bandcamp-essential-releases-january-18-2018/
45,1/6/20 11:39am,Bandcamp,package,Uchronia – Field Recordings From Alternate Realities,Sahel Sounds,USD,7.0,1.0,,7.0,,4.0,United States,0.51,paypal,11.0,0.0,1227566407,,0.7,0.7,0.0,9.79,273.97,5.79,Uchronia – Field Recordings From Alternate Realities photo book,,http://sahelsounds.bandcamp.com/merch/uchronia-field-recordings-from-alternate-realities-photo-book,SS-000book,,,,Ricky Harmon,ubaker@gmail.com,+1-083-308-1536x352,,Daniel Quinn,4901 Rachael Rue,,Bordentown,NJ,8505,United States,US,1/7/20,,United States,US,NJ,Bordentown,,
46,1/6/20 4:12pm,Bandcamp,album,Music from Saharan Cellphones,Various,USD,7.0,1.0,,7.0,1.47,,,0.55,paypal,8.47,0.0,4270334326,,0.7,0.7,0.0,5.75,279.72,5.75,digital download,,http://sahelsounds.bandcamp.com/album/music-from-saharan-cellphones,,SS-003,889326 667889,,Brooke Brewer,lcabrera@gmail.com,+1-740-610-2085x1695,,Tina Callahan,426 Carpenter Mountain,,,,,,,,,Spain,ES,Zamora,Zamora,Google search,www.google.com/
47,1/6/20 6:03pm,shop@sahelsounds.com,payout,,,USD,,,,,,,,1.75,transfer,174.98,173.23,t249225035,3A303267HF365590V,,,,-174.98,104.74,,,,,,,,,,,,,,,,,,,,,,,,,,,,
48,1/6/20 6:03pm,shop@sahelsounds.com,payout,,,USD,,,,,,,,0.29,transfer,29.29,29.0,t249225036,8ED5856227494100C,,,,-29.29,75.45,,,,,,,,,,,,,,,,,,,,,,,,,,,,
49,1/6/20 7:15pm,Bandcamp,package,Ilana: The Creator,Mdou Moctar,USD,20.0,1.0,,20.0,,5.0,United States,0.78,paypal,25.0,0.0,3770368761,,2.0,2.0,0.0,22.22,97.67,17.22,Ilana LP,,http://mdoumoctar.bandcamp.com/album/ilana-the-creator,SS-051lp,SS-051,602318 136893,,Charles Campbell,thomasjackson@shelton-davis.com,453.410.7899x11459,,Walter Crawford,0126 Bolton Roads,,Mission Viejo,CA,92692,United States,US,1/7/20,,United States,US,CA,Mission Viejo,,
50,1/6/20 8:03pm,Bandcamp,album,Ilana: The Creator,Mdou Moctar,USD,10.0,1.0,,10.0,1.33,,,1.29,paypal,11.33,0.0,1190096259,,1.0,0.0,1.0,0.0,97.67,7.71,digital download,,http://mdoumoctar.bandcamp.com/album/ilana-the-creator,,SS-051,602318 136893,,Michelle Arnold,pooletim@stewart-welch.com,001-660-141-4600,,Jessica Noble,0066 Jose Centers Suite 287,,,,,,,,,Germany,DE,North Rhine-Westphalia,Siegen,Bandcamp artist: mdoumoctar,mdoumoctar.bandcamp.com
51,1/6/20 8:03pm,Bandcamp,album,Sousoume Tamachek,Mdou Moctar,USD,10.0,1.0,,10.0,1.33,,,,,11.33,0.0,1190096259,,1.0,0.0,2.0,0.0,97.67,9.0,digital download,,http://mdoumoctar.bandcamp.com/album/sousoume-tamachek,,SS-043,191515 769435,,Christopher Miller,greenedylan@flores.com,561.476.1302x8676,,Suzanne Maldonado,7720 Smith Motorway Apt. 513,,,,,,,,,Germany,DE,North Rhine-Westphalia,Siegen,Bandcamp artist: mdoumoctar,mdoumoctar.bandcamp.com
52,1/6/20 8:03pm,Bandcamp,album,Akounak Tedalat Taha Tazoughai OST,Mdou Moctar,USD,10.0,1.0,,10.0,1.33,,,,,11.33,0.0,1190096259,,1.0,3.0,0.0,25.71,123.38,9.0,digital download,,http://mdoumoctar.bandcamp.com/album/akounak-tedalat-taha-tazoughai-ost,,SS-028,889326 667599,,Elizabeth Crawford,vanessa74@gmail.com,(040)388-6213x868,,Corey Berger,799 Tyrone Mountain,,,,,,,,,Germany,DE,North Rhine-Westphalia,Siegen,Bandcamp artist: mdoumoctar,mdoumoctar.bandcamp.com
53,1/6/20 8:21pm,Bandcamp,album,Ilana: The Creator,Mdou Moctar,USD,7.0,1.0,,7.0,,,,0.4,paypal,7.0,0.0,2111585099,,0.7,0.7,0.0,5.9,129.28,5.9,digital download,,http://mdoumoctar.bandcamp.com/album/ilana-the-creator,,SS-051,602318 136893,,Annette Reid,kbailey@bond.com,0931128412,,Sara Daugherty,019 Alyssa Squares Suite 650,,,,,,,,,United States,US,NY,New York,Google search,www.google.com/
54,1/7/20 12:11am,Bandcamp,album,Music from Saharan Cellphones,Various,USD,7.0,1.0,,7.0,,,,0.4,credit card,7.0,0.0,3704492819,,0.7,0.7,0.0,5.9,135.18,5.9,digital download,,http://sahelsounds.bandcamp.com/album/music-from-saharan-cellphones,,SS-003,889326 667889,,Bruce Patel,trevor92@webb.net,754-695-2521x3775,,Susan Gutierrez,2923 John Isle Suite 990,,,,,,,,,United States,US,MI,Delton,t.umblr.com,t.umblr.com/
55,1/7/20 2:21am,Bandcamp,album,Music from Saharan Cellphones,Various,USD,7.0,1.0,,7.0,,,,0.4,credit card,7.0,0.0,834140529,,0.7,0.7,0.0,5.9,141.08,5.9,digital download,,http://sahelsounds.bandcamp.com/album/music-from-saharan-cellphones,,SS-003,889326 667889,,Allen Griffin,maria01@gmail.com,881-901-1100x88388,,Amber Thomas,3203 King Viaduct Apt. 505,,,,,,,,,United States,US,CA,Riverside,,
56,1/7/20 5:29am,Bandcamp,package,Ilana: The Creator,Mdou Moctar,USD,12.0,1.0,,12.0,,3.0,United States,0.59,paypal,15.0,0.0,580129097,,1.2,1.2,0.0,13.21,154.29,10.21,Ilana: The Creator CD,,http://mdoumoctar.bandcamp.com/album/ilana-the-creator,SS-051cd,SS-051,602318 136893,,Candace Cain,myerskaitlin@yahoo.com,001-415-612-6456,,Autumn Ross,8334 Hall Curve Apt. 634,,Bellingham,WA,98225,United States,US,1/7/20,,United States,US,WA,Bellingham,Google search,www.google.com/
57,1/7/20 1:44pm,Bandcamp,album,Ilana: The Creator,Mdou Moctar,USD,7.0,1.0,,7.0,1.33,,,0.57,credit card,8.33,0.0,3220833699,,0.7,0.7,0.0,5.73,160.02,5.73,digital download,,http://mdoumoctar.bandcamp.com/album/ilana-the-creator,,SS-051,602318 136893,,Samantha Wood,zmoran@wolf.com,023.118.4935x5056,,Sara Smith,730 Joseph Row Suite 321,,,,,,,,,Germany,DE,Land Berlin,Berlin,Bandcamp search,bandcamp.com/autocomplete-search
58,1/7/20 5:57pm,Bandcamp,package,Les Filles de Illighadad,Les Filles de Illighadad,USD,45.0,1.0,,45.0,,5.0,United States,1.44,paypal,50.0,0.0,1730397136,,4.5,0.0,4.5,0.0,160.02,39.06,Les Filles de Illighadad LP,,http://lesfillesdeillighadad.bandcamp.com/album/les-filles-de-illighadad,SS-033-LP,SS-033,889326 664918,,Tracy Washington,kstewart@gmail.com,+1-830-384-8746x09370,,Crystal Moore,85472 Nancy View Suite 790,,Louisville,KY,40206,United States,US,1/7/20,,United States,US,KY,Louisville,,
59,1/7/20 5:57pm,Bandcamp,album,Les Filles de Illighadad,Les Filles de Illighadad,USD,10.0,1.0,,10.0,,,,,,10.0,0.0,1730397136,,1.0,5.5,0.0,53.06,213.08,9.0,digital download,,http://lesfillesdeillighadad.bandcamp.com/album/les-filles-de-illighadad,,SS-033,889326 664918,,Cesar Parsons,vgray@abbott.com,7978762633,,Timothy Snyder,85383 Perez Island Suite 712,,Louisville,KY,40206,,,,,United States,US,KY,Louisville,,
60,1/7/20 6:02pm,shop@sahelsounds.com,payout,,,USD,,,,,,,,0.58,transfer,57.82,57.24,t249453772,2VS78730S0409511H,,,,-57.82,155.26,,,,,,,,,,,,,,,,,,,,,,,,,,,,
61,1/7/20 6:03pm,shop@sahelsounds.com,payout,,,USD,,,,,,,,0.18,transfer,17.63,17.45,t249453773,67K84594YH342901F,,,,-17.63,137.63,,,,,,,,,,,,,,,,,,,,,,,,,,,,
62,1/7/20 6:48pm,Bandcamp,package,Ilana: The Creator,Mdou Moctar,USD,8.0,1.0,,8.0,,4.0,United States,0.56,credit card,12.0,0.0,485823553,,0.8,0.8,0.0,10.64,148.27,6.64,Ilana: The Creator cassette,,http://mdoumoctar.bandcamp.com/album/ilana-the-creator,SS-028cs,SS-051,602318 136893,,Christopher Johnson,khiggins@swanson-brennan.com,806-799-2651,,Anthony Cooley,55153 James Well,,St. Louis,MO,63117,United States,US,,,United States,US,MO,St. Louis,Google search,www.google.com/
63,1/7/20 8:30pm,Bandcamp,album,Takamba WhatsApp 2018 EP,Tallawit Timbouctou,USD,5.0,1.0,,5.0,,,,0.56,credit card,5.0,0.0,2925948488,,0.5,0.0,0.5,0.0,148.27,3.94,digital download,,http://tallawit.bandcamp.com/album/takamba-whatsapp-2018-ep,,SS-056,602318 137098,,Robert Shaw,kellywalters@yahoo.com,+1-207-878-3829,,Timothy Thornton,46433 Marisa Center Apt. 451,,,,,,,,,United States,US,CA,Costa Mesa,,
64,1/7/20 8:30pm,Bandcamp,album,Eghass Malan,Les Filles de Illighadad,USD,7.0,1.0,,7.0,,,,,,7.0,0.0,2925948488,,0.7,1.2,0.0,10.24,158.51,6.3,digital download,,http://lesfillesdeillighadad.bandcamp.com/album/eghass-malan,,SS-044,191515 928351,,Amy Cochran,robertmatthews@reyes-hodges.com,828-676-3287x7092,,Danielle Gray,3589 Theresa Route,,,,,,,,,United States,US,CA,Costa Mesa,,
65,1/7/20 9:09pm,Bandcamp,package,Ilana: The Creator,Mdou Moctar,USD,20.0,1.0,,20.0,,5.0,United States,0.85,credit card,25.0,0.0,1640180674,,2.0,2.0,0.0,22.15,180.66,17.15,Ilana LP,,http://mdoumoctar.bandcamp.com/album/ilana-the-creator,SS-051lp,SS-051,602318 136893,,Joseph Alvarado,stanley48@yahoo.com,725-948-8071x506,,James Rodriguez,6523 Meghan Alley Apt. 386,,Pewaukee,WI,53072,United States,US,1/7/20,,United States,US,WI,Pewaukee,Google search,www.google.com/
66,1/7/20 11:47pm,Bandcamp,album,Music from Saharan Cellphones,Various,USD,7.0,1.0,,7.0,,,,0.4,credit card,7.0,0.0,2792792601,,0.7,0.7,0.0,5.9,186.56,5.9,digital download,,http://sahelsounds.bandcamp.com/album/music-from-saharan-cellphones,,SS-003,889326 667889,,Gregory Thomas,smithashley@yahoo.com,497-435-4538,,Deborah Ochoa,74417 Sims Crossing,,,,,,,,,United States,US,MA,Wareham,,
67,1/8/20 12:01am,Bandcamp,package,Sahel Sounds Label Sampler,Various Artists,USD,20.0,1.0,,20.0,,15.0,United States,1.32,paypal,35.0,0.0,2331850376,,2.0,2.0,0.0,31.68,218.24,16.68,Sahel Sounds t-shirt,Medium,http://sahelsounds.bandcamp.com/merch/sahel-sounds-t-shirt,SS-T01-BLK-UMD,,,,James Sutton,hodgeeric@harris.com,(236)890-6102x67615,,Michael Mathis,1788 Scott Viaduct Apt. 210,,Leipzig,,4105,Germany,DE,1/14/20,,Germany,DE,,Leipzig,,
68,1/8/20 3:23am,Bandcamp,album,Ilana: The Creator,Mdou Moctar,USD,7.0,1.0,,7.0,,,,0.4,paypal,7.0,0.0,1518195584,,0.7,0.7,0.0,5.9,224.14,5.9,digital download,,http://mdoumoctar.bandcamp.com/album/ilana-the-creator,,SS-051,602318 136893,,Jeffrey Evans,williamcarter@hotmail.com,277-443-3966,,Keith Bright,2316 Wilson Locks Suite 080,,,,,,,,,United States,US,VA,,Bandcamp artist: sunburnedhandoftheman,sunburnedhandoftheman.bandcamp.com/album/no-magic-man
69,1/8/20 3:31am,Bandcamp,album,Houmeissa,Hama,USD,7.0,1.0,,7.0,,,,0.4,paypal,7.0,0.0,4138154925,,0.7,0.7,0.0,5.9,230.04,5.9,digital download,,http://hamasynth.bandcamp.com/album/houmeissa,,SS-049,656605 382364,,Nathan Rodriguez,anablanchard@cook-moore.net,001-526-566-1817x159,,Edwin Alvarez,497 Kelly Island Apt. 445,,,,,,,,,United States,US,WA,Puyallup,noweidzieodmorza.com (embedded player),noweidzieodmorza.com/en/12031-tuareg-disco-and-electronic-cumbia/
70,1/8/20 4:30am,Bandcamp,package,Ilana: The Creator,Mdou Moctar,USD,12.0,1.0,,12.0,,10.0,United States,1.0,credit card,22.0,0.0,2775170370,,1.2,1.2,0.0,19.8,249.84,9.8,Ilana: The Creator CD,,http://mdoumoctar.bandcamp.com/album/ilana-the-creator,SS-051cd,SS-051,602318 136893,,Laura Lopez,blankenshipjerome@gmail.com,5857885913,,Kelsey Frazier,4872 Fernandez Views,Montaillon,Aigondigné,,79370,France,FR,1/14/20,,France,FR,,Aigondigné,,
71,1/8/20 4:56am,Bandcamp,album,Ilana: The Creator,Mdou Moctar,USD,7.0,1.0,,7.0,,,,0.4,credit card,7.0,0.0,439280446,,0.7,0.7,0.0,5.9,255.74,5.9,digital download,,http://mdoumoctar.bandcamp.com/album/ilana-the-creator,,SS-051,602318 136893,,Ashley Vang,washingtonchloe@gmail.com,+1-259-351-6453x24267,,Ann Carter,0091 Stokes Camp,,,,,,,,,United States,US,NY,New York,Google search,www.google.com/
72,1/8/20 11:11am,Bandcamp,package,Ilana: The Creator,Mdou Moctar,USD,17.0,1.0,,17.0,,20.0,United States,1.48,credit card,37.0,0.0,663153627,,1.7,1.7,0.0,33.82,289.56,13.82,Ilana LP,,http://mdoumoctar.bandcamp.com/album/ilana-the-creator,SS-051lp,SS-051,602318 136893,,Jerry Henry,nicole59@gmail.com,523-639-6112,,David Brewer,3226 Anderson Walks,,Gdańsk,Pomorskie,80-322,Poland,PL,1/14/20,,Poland,PL,Pomorskie,Gdańsk,Bandcamp search: “mdou moctar”,bandcamp.com/search?q=Mdou%20Moctar
73,1/8/20 12:20pm,Bandcamp,album,Tiris,El Wali,USD,7.0,1.0,,7.0,1.61,,,0.55,paypal,8.61,0.0,2442124056,,0.7,0.7,0.0,5.75,295.31,5.75,digital download,,http://elwali.bandcamp.com/album/tiris,,SS-055,602318 136923,,Carly Townsend,christinewilliams@choi.com,001-956-348-8006,"Thanks for wonderfull music, best wishes from Poland",Rachel Burns,0242 Larsen Mission Apt. 624,,,,,,,,,Poland,PL,Greater Poland,Poznan,smarturl.it,smarturl.it/elwalitiris
74,1/8/20 3:02pm,Bandcamp,album,Les Filles de Illighadad,Les Filles de Illighadad,USD,7.0,1.0,,7.0,,,,0.47,paypal,7.0,0.0,3509363126,,0.7,0.7,0.0,5.83,301.14,5.83,digital download,,http://lesfillesdeillighadad.bandcamp.com/album/les-filles-de-illighadad,,SS-033,889326 664918,,Jim Carpenter,sean85@mitchell-williams.biz,585-144-9097,,Gerald Smith,3449 Howard Ranch,,,,,,,,,Switzerland,CH,Bern,Bern,youtube.com,www.youtube.com/
75,1/8/20 3:04pm,Bandcamp,album,Les Filles de Illighadad,Les Filles de Illighadad,USD,7.0,1.0,,7.0,,,,0.4,paypal,7.0,0.0,4026407978,,0.7,0.7,0.0,5.9,307.04,5.9,digital download,,http://lesfillesdeillighadad.bandcamp.com/album/les-filles-de-illighadad,,SS-033,889326 664918,,Jennifer Cunningham,khardy@blankenship.net,476.322.9453x146,,Ronald Warren,95407 Cook Trace,,,,,,,,,United States,US,GA,Athens,Bandcamp fan wishlist,bandcamp.com/scottcreney
76,1/8/20 3:06pm,Bandcamp,album,Sahel Sounds Label Sampler,Various Artists,USD,1.0,1.0,,1.0,,,,0.1,credit card,1.0,0.0,3528986191,,0.1,0.1,0.0,0.8,307.84,0.8,digital download,,http://sahelsounds.bandcamp.com/album/sahel-sounds-label-sampler,,SS-058,602318 137111,,Leslie Andrews,rnorton@andrews.com,891-255-8074,,Denise Gray,12245 Jones Isle Apt. 874,,,,,,,,,United States,US,GA,Athens,bandcamp.com,bandcamp.com
77,1/8/20 3:24pm,Bandcamp,album,Abba Gargando,Abba Gargando,USD,7.0,1.0,,7.0,,,,0.4,credit card,7.0,0.0,2217441811,,0.7,0.7,0.0,5.9,313.74,5.9,digital download,,http://abbagargando.bandcamp.com/album/abba-gargando,,SS-029,889326 664888,,Eileen Molina,diazlogan@ross.net,001-435-294-7971,,Phillip Terry,520 Ponce Village,,,,,,,,,United States,US,CA,San Diego,Bandcamp fan wishlist,bandcamp.com/sleezsisters
78,1/8/20 5:11pm,Bandcamp,package,Ilana: The Creator,Mdou Moctar,USD,20.0,1.0,,20.0,,5.0,United States,0.85,credit card,25.0,0.0,172215775,,2.0,2.0,0.0,22.15,335.89,17.15,Ilana LP,,http://mdoumoctar.bandcamp.com/album/ilana-the-creator,SS-051lp,SS-051,602318 136893,,Steven Gordon,gjones@jones.net,+1-741-424-6367x431,,Christopher Combs,19129 Christy Hill,,Alameda,CA,94501,United States,US,1/14/20,,United States,US,CA,Alameda,Google search,www.google.com/
79,1/8/20 5:16pm,Bandcamp,album,Anou Malane,Abdallah Ag Oumbadougou,USD,7.0,1.0,,7.0,,,,0.47,paypal,7.0,0.0,2366067448,,0.7,0.7,0.0,5.83,341.72,5.83,digital download,,http://abdallahagoumbadougou.bandcamp.com/album/anou-malane,,SS-053,602318 136992,,Sabrina Dorsey,froberts@bell.info,(784)984-9147,,Amy Anderson,0178 Alexandra Mews Apt. 205,,,,,,,,,Canada,CA,QC,Montreal,Google search,www.google.com/
80,1/8/20 5:54pm,Bandcamp,album,Ilana: The Creator,Mdou Moctar,USD,7.0,1.0,,7.0,,,,0.4,credit card,7.0,0.0,2340191758,,0.7,0.7,0.0,5.9,347.62,5.9,digital download,,http://mdoumoctar.bandcamp.com/album/ilana-the-creator,,SS-051,602318 136893,,Tracy Mitchell,welchvictoria@yahoo.com,701-799-5786x3549,,Erin Flores,051 Adam Dale Apt. 972,,,,,,,,,United States,US,AZ,Phoenix,Bandcamp home page,bandcamp.com/
81,1/8/20 6:02pm,shop@sahelsounds.com,payout,,,USD,,,,,,,,1.2,transfer,119.93,118.73,t249682553,0B101251FX406402W,,,,-119.93,227.69,,,,,,,,,,,,,,,,,,,,,,,,,,,,
82,1/8/20 6:02pm,shop@sahelsounds.com,payout,,,USD,,,,,,,,0.18,transfer,17.7,17.52,t249682546,2J4410888S470472X,,,,-17.7,209.99,,,,,,,,,,,,,,,,,,,,,,,,,,,,
83,1/8/20 6:50pm,Bandcamp,refund,Ilana: The Creator,Mdou Moctar,USD,8.0,-1.0,,-8.0,,-4.0,United States,-0.56,credit card,-12.0,,t249475596,,-0.8,-0.8,0.0,-10.64,199.35,,Ilana: The Creator cassette,,http://mdoumoctar.bandcamp.com/album/ilana-the-creator,SS-028cs,SS-051,602318 136893,,Gail Rodriguez,tcoleman@hotmail.com,850-785-2818,,Felicia Ashley,23679 Beck Point Suite 417,,St. Louis,MO,63117,United States,US,,,United States,US,MO,St. Louis,Google search,www.google.com/
84,1/8/20 7:52pm,Bandcamp,package,Eghass Malan,Les Filles de Illighadad,USD,17.0,1.0,,17.0,,17.0,United States,1.29,paypal,34.0,0.0,3149773712,,1.7,1.7,0.0,31.01,230.36,14.01,'Eghass Malan' LP,,http://lesfillesdeillighadad.bandcamp.com/album/eghass-malan,SS-044lp-1,SS-044,191515 928351,,Brenda Scott,richard59@hotmail.com,+1-604-230-8736x089,,Rebecca Walter,56031 Shawna Shores Apt. 150,,Kitchener,ON,N2E3L7,Canada,CA,1/14/20,,Canada,CA,ON,Kitchener,rateyourmusic.com (embedded player),rateyourmusic.com/release/album/les-filles-de-illighadad/eghass-malan/
85,1/8/20 7:55pm,Bandcamp,album,Eghass Malan,Les Filles de Illighadad,USD,7.0,1.0,,7.0,1.4,,,0.54,paypal,8.4,0.0,4057087888,,0.7,0.7,0.0,5.76,236.12,5.76,digital download,,http://lesfillesdeillighadad.bandcamp.com/album/eghass-malan,,SS-044,191515 928351,,Catherine Mendez,spencerlee@yahoo.com,621-225-0345x5559,,Lee West,64499 Wheeler Wells Apt. 520,,,,,,,,,France,FR,Maine-et-Loire,Angers,,
86,1/8/20 8:47pm,Bandcamp,track,Anou Malane,Abdallah Ag Oumbadougou,USD,1.0,1.0,,1.0,0.2,,,0.12,paypal,1.2,0.0,3349888358,,0.1,0.1,0.0,0.78,236.9,0.78,digital download,,http://abdallahagoumbadougou.bandcamp.com/track/anou-malane,,SS-053,,,Emily Valentine,gary81@wallace.info,(156)949-7557,,Jeremy Williams,4196 Flores Points,,,,,,,,,United Kingdom,GB,Hammersmith and Fulham,Shepherds Bush,,
87,1/8/20 9:53pm,Bandcamp,album,Sahel Sounds Label Sampler,Various Artists,USD,1.0,1.0,,1.0,,,,0.11,paypal,1.0,0.0,2123095500,,0.1,0.1,0.0,0.79,237.69,0.79,digital download,,http://sahelsounds.bandcamp.com/album/sahel-sounds-label-sampler,,SS-058,602318 137111,,Kristin Farley,kellytyler@hotmail.com,232-657-7908,,Deborah Hardin,8956 Terry Cape,,,,,,,,,United Kingdom,GB,Hackney,Hackney,Google search,www.google.co.uk/
88,1/9/20 1:10am,Bandcamp,package,Ilana: The Creator,Mdou Moctar,USD,45.0,1.0,,45.0,,6.0,United States,1.27,paypal,51.0,0.0,2320295181,,4.5,4.5,0.0,45.23,282.92,39.23,Ilana The Creator shirt & LP bundle,LARGE,http://mdoumoctar.bandcamp.com/merch/ilana-the-creator-shirt-lp-bundle,SS-051lp*-T02-W-ULG,,,,Pamela Bradley,cgutierrez@gmail.com,9701804940,,Amanda Washington,382 Ortega Valleys,277 East 1500 North,Orem,UT,84057,United States,US,1/14/20,,United States,US,UT,Orem,Bandcamp search,bandcamp.com/autocomplete-search
89,1/9/20 4:00am,Bandcamp,package,Nouakchott Wedding Songs,Various,USD,12.0,1.0,,12.0,,5.0,United States,0.62,paypal,17.0,0.0,2061788921,,1.2,1.2,0.0,15.18,298.1,10.18,Nouakchott Wedding Songs LP - Warehouse find!,,http://sahelsounds.bandcamp.com/album/nouakchott-wedding-songs,SS-027-LP,SS-027,889326 667797,,Maurice Chandler,wenglish@kirk.org,+1-159-761-3465x4901,,Danielle Wyatt,170 Felicia Corner Suite 152,,Los Angeles,CA,90041,United States,US,1/14/20,,United States,US,CA,Los Angeles,Bandcamp search,bandcamp.com/autocomplete-search
90,1/9/20 4:24am,Bandcamp,album,Sousoume Tamachek,Mdou Moctar,USD,7.0,1.0,,7.0,,,,0.4,paypal,7.0,0.0,7209585,,0.7,0.7,0.0,5.9,304.0,5.9,digital download,,http://mdoumoctar.bandcamp.com/album/sousoume-tamachek,,SS-043,191515 769435,,Heather Porter,pcollins@frank-larson.org,9703504510,,Scott Hamilton,544 Cynthia Mountains,,,,,,,,,United States,US,CA,San Diego,,
91,1/9/20 4:40am,Bandcamp,album,Ilana: The Creator,Mdou Moctar,USD,10.0,1.0,,10.0,,,,1.29,paypal,10.0,0.0,570320528,,1.0,0.0,1.0,0.0,304.0,7.71,digital download,,http://mdoumoctar.bandcamp.com/album/ilana-the-creator,,SS-051,602318 136893,,Rose Williams,stacymeyer@yahoo.com,351-204-5422,,Tonya Keller,91387 Travis Causeway,,,,,,,,,United States,US,CA,San Diego,bandcamp.com,bandcamp.com
92,1/9/20 4:40am,Bandcamp,album,Akounak Tedalat Taha Tazoughai OST,Mdou Moctar,USD,7.0,1.0,,7.0,,,,,,7.0,0.0,570320528,,0.7,0.0,1.7,0.0,304.0,6.3,digital download,,http://mdoumoctar.bandcamp.com/album/akounak-tedalat-taha-tazoughai-ost,,SS-028,889326 667599,,Sharon Dunn,fwright@smith.com,001-808-933-0097x9448,,Jonathan Garcia,15747 Robert Course Apt. 999,,,,,,,,,United States,US,CA,San Diego,bandcamp.com,bandcamp.com
93,1/9/20 4:40am,Bandcamp,album,Anar,Mdou Moctar,USD,7.0,1.0,,7.0,,,,,,7.0,0.0,570320528,,0.7,0.0,2.4,0.0,304.0,6.3,digital download,,http://mdoumoctar.bandcamp.com/album/anar,,SS-024,889326 664857,,Anthony Rodriguez,ann60@hotmail.com,003.833.8444x648,,Henry Luna,207 Amanda Branch,,,,,,,,,United States,US,CA,San Diego,bandcamp.com,bandcamp.com
94,1/9/20 4:40am,Bandcamp,album,Afelan,Mdou Moctar,USD,7.0,1.0,,7.0,,,,,,7.0,0.0,570320528,,0.7,0.0,3.1,0.0,304.0,6.3,digital download,,http://mdoumoctar.bandcamp.com/album/afelan,,SS-017,889326 664840,,Michael Howard,myoung@gmail.com,001-753-943-5513x160,,Christopher Turner,30240 Carlson View Apt. 412,,,,,,,,,United States,US,CA,San Diego,bandcamp.com,bandcamp.com
95,1/9/20 4:40am,Bandcamp,album,Unreleased Tapes 1981-1984,Mamman Sani,USD,7.0,1.0,,7.0,,,,,,7.0,0.0,570320528,,0.7,0.0,3.8,0.0,304.0,6.3,digital download,,http://mammansani.bandcamp.com/album/unreleased-tapes-1981-1984,,SS-030,889326 667568,,Louis Davis,smithsteve@hotmail.com,(666)423-0362x4598,,Joseph Hall,56505 Parsons Prairie Suite 839,,,,,,,,,United States,US,CA,San Diego,,
96,1/9/20 4:40am,Bandcamp,album,La Musique Electronique du Niger,Mamman Sani,USD,7.0,1.0,,7.0,,,,,,7.0,0.0,570320528,,0.7,0.0,4.5,0.0,304.0,6.3,digital download,,http://mammansani.bandcamp.com/album/la-musique-electronique-du-niger,,SS-011,889326 664864,,Kristina Ayala,joshua36@krause.com,(140)771-3726x6702,,Jeffrey Weaver,52131 Anthony Burgs,,,,,,,,,United States,US,CA,San Diego,,
97,1/9/20 4:40am,Bandcamp,album,Taaritt,Mamman Sani,USD,7.0,1.0,,7.0,,,,,,7.0,0.0,570320528,,0.7,5.2,0.0,45.51,349.51,6.3,digital download,,http://mammansani.bandcamp.com/album/taaritt,,SS-023,889326 664871,,Elizabeth Thompson,alexanderhouston@spence-jordan.com,490-475-7314x773,,James Perez,944 Whitney Causeway Suite 422,,,,,,,,,United States,US,CA,San Diego,,
98,1/9/20 6:45am,Bandcamp,package,Ilana: The Creator,Mdou Moctar,USD,17.0,1.0,,17.0,,5.0,United States,0.78,credit card,22.0,0.0,825417674,,1.7,1.7,0.0,19.52,369.03,14.52,Ilana LP,,http://mdoumoctar.bandcamp.com/album/ilana-the-creator,SS-051lp,SS-051,602318 136893,,Amy Larson,haleyrivas@boone.com,808.372.8576x37170,,Jessica Jimenez,2636 Owens Views Apt. 041,,Decatur,GA,30032,United States,US,1/14/20,,United States,US,GA,Decatur,Bandcamp artist: kikagakumoyoggb,kikagakumoyoggb.bandcamp.com
99,1/9/20 7:55am,Bandcamp,package,Ilana: The Creator,Mdou Moctar,USD,12.0,1.0,,12.0,,10.0,United States,0.94,paypal,22.0,0.0,1439953012,,1.2,1.2,0.0,19.86,388.89,9.86,Ilana: The Creator CD,,http://mdoumoctar.bandcamp.com/album/ilana-the-creator,SS-051cd,SS-051,602318 136893,,Carol Hawkins,patrickgentry@garcia.com,(153)345-9548x582,,Franklin Kelly,1468 Thompson Valley,,STRASBOURG,,67100,France,FR,1/14/20,,France,FR,,STRASBOURG,Google search,www.google.com/
100,1/9/20 8:22am,Bandcamp,album,Ilana: The Creator,Mdou Moctar,USD,7.0,1.0,,7.0,1.68,,,0.58,credit card,8.68,0.0,3178203106,,0.7,0.7,0.0,5.72,394.61,5.72,digital download,,http://mdoumoctar.bandcamp.com/album/ilana-the-creator,,SS-051,602318 136893,,Patricia Harris,stephenortega@fisher-mack.info,+1-321-440-6952x203,,Ashley Hansen,269 Thomas Courts Suite 691,,,,,,,,,Finland,FI,Uusimaa,Helsinki,Bandcamp search: “mdou moctar”,bandcamp.com/search?q=Mdou%20Moctar
101,1/9/20 9:50am,Bandcamp,package,La Musique Electronique du Niger,Mamman Sani,USD,17.0,1.0,,17.0,,24.0,United States,2.38,credit card,41.0,0.0,3059667953,,1.7,0.0,1.7,0.0,394.61,12.92,Mamman Sani remastered LP,,http://mammansani.bandcamp.com/album/la-musique-electronique-du-niger,SS-011lp-1,SS-011,889326 664864,,Ronnie Guzman,ryanmiller@yahoo.com,+1-114-758-1146x75314,,Adrian Lyons,89278 Larry Loop,,Noisy le sec,,93130,France,FR,1/14/20,,France,FR,,Noisy le sec,Bandcamp artist: mammansani,mammansani.bandcamp.com/album/taaritt
102,1/9/20 9:50am,Bandcamp,package,Taaritt,Mamman Sani,USD,17.0,1.0,,17.0,,7.0,United States,,,24.0,0.0,3059667953,,1.7,3.4,0.0,59.22,453.83,15.3,Taaritt LP,,http://mammansani.bandcamp.com/album/taaritt,SS-023lp,SS-023,889326 664871,,Lindsay Flores,xmorse@phillips-russell.com,001-980-933-4715x50635,,Michael Howard,2011 Jessica Oval,,Noisy le sec,,93130,France,FR,1/14/20,,France,FR,,Noisy le sec,,
103,1/9/20 11:52am,Bandcamp,package,Akounak Tedalat Taha Tazoughai OST,Mdou Moctar,USD,17.0,1.0,,17.0,,24.0,United States,2.28,credit card,41.0,0.0,3493612968,,1.7,0.0,1.7,0.0,453.83,13.02,Akounak OST LP,,http://mdoumoctar.bandcamp.com/album/akounak-tedalat-taha-tazoughai-ost,SS-028lp-1,SS-028,889326 667599,,Debra Mills,william64@martinez.net,512-792-7188x83713,,James Stewart,89097 Zamora Island Apt. 635,,Flawil,St.Gallen,9230,Switzerland,CH,1/14/20,,Switzerland,CH,St.Gallen,Flawil,Bandcamp fan page: backspace,bandcamp.com/backspace
104,1/9/20 11:52am,Bandcamp,package,Ilana: The Creator,Mdou Moctar,USD,17.0,1.0,,17.0,,4.0,United States,,,21.0,0.0,3493612968,,1.7,3.4,0.0,56.32,510.15,15.3,Ilana LP,,http://mdoumoctar.bandcamp.com/album/ilana-the-creator,SS-051lp,SS-051,602318 136893,,Marc Valencia,rterry@yahoo.com,686-434-8345x5747,,Alyssa Chambers,25919 Dunn Inlet Suite 732,,Flawil,St.Gallen,9230,Switzerland,CH,1/14/20,,Switzerland,CH,St.Gallen,Flawil,Bandcamp fan page: backspace,bandcamp.com/backspace
105,1/9/20 12:06pm,Bandcamp,album,Terrouzi,Ahmedou Ahmed Lowla,USD,7.0,1.0,,7.0,1.47,,,0.57,credit card,8.47,0.0,3075661701,,0.7,0.7,0.0,5.73,515.88,5.73,digital download,,http://ahmedouahmedlowla.bandcamp.com/album/terrouzi,,SS-054,602318 137029,,Barry White,christopher77@morales.net,703.571.7382x381,,John Gross,8668 Melinda Inlet Suite 478,,,,,,,,,Indonesia,ID,West Java,Bandung,planetrock-booking.de,www.planetrock-booking.de/44-0-Ahmedou-Ahmed-Lowla.html
106,1/9/20 2:52pm,Bandcamp,album,Eghass Malan,Les Filles de Illighadad,USD,7.0,1.0,,7.0,1.47,,,0.57,credit card,8.47,0.0,616892088,,0.7,0.7,0.0,5.73,521.61,5.73,digital download,,http://lesfillesdeillighadad.bandcamp.com/album/eghass-malan,,SS-044,191515 928351,,Christine Vance,matthew36@gmail.com,707.979.6447,,Monica Smith,53821 Eric Village,,,,,,,,,Portugal,PT,Lisbon,Lisbon,,
107,1/9/20 3:31pm,Bandcamp,album,Ilana: The Creator,Mdou Moctar,USD,7.0,1.0,,7.0,1.4,,,0.54,gift card,8.4,0.0,3634185314,,0.7,0.7,0.0,5.76,527.37,5.76,digital download,,http://mdoumoctar.bandcamp.com/album/ilana-the-creator,,SS-051,602318 136893,,Olivia Moore,ymoore@yahoo.com,+1-858-752-2948x9033,,Tracy Hall,22634 Samantha Mountain,,,,,,,,,United Kingdom,GB,England,London,Bandcamp home page,bandcamp.com/
108,1/9/20 6:03pm,shop@sahelsounds.com,payout,,,USD,,,,,,,,1.46,transfer,145.59,144.13,t249919509,3HA92000K69609412,,,,-145.59,381.78,,,,,,,,,,,,,,,,,,,,,,,,,,,,
109,1/9/20 6:03pm,shop@sahelsounds.com,payout,,,USD,,,,,,,,0.54,transfer,53.76,53.22,t249919504,3C535981WR947813A,,,,-53.76,328.02,,,,,,,,,,,,,,,,,,,,,,,,,,,,
110,1/9/20 7:00pm,Bandcamp,package,Eghass Malan,Les Filles de Illighadad,USD,17.0,1.0,,17.0,,5.0,United States,0.72,paypal,22.0,0.0,4113180121,,1.7,1.7,0.0,19.58,347.6,14.58,'Eghass Malan' LP,,http://lesfillesdeillighadad.bandcamp.com/album/eghass-malan,SS-044lp-1,SS-044,191515 928351,,Christopher Bowman,patrickkramer@weaver-lowe.com,185.621.8340,,Brenda Lopez,3327 White Junctions Suite 733,,Ann Arbor,MI,48103,United States,US,1/14/20,,United States,US,MI,Ann Arbor,Google search,www.google.com/
111,1/9/20 9:27pm,Bandcamp,package,Ilana: The Creator,Mdou Moctar,USD,30.0,1.0,,30.0,,5.0,United States,0.97,paypal,35.0,0.0,500488063,,3.0,3.0,0.0,31.03,378.63,26.03,Ilana: The Creator shirt,Large,http://mdoumoctar.bandcamp.com/merch/ilana-the-creator-shirt,SS-MDOU-BIRD-SHIRT-L,,,,Jaime Brown,collierjulia@ellison.com,+1-645-337-2166x517,,Marcus Kelley,711 Garcia Circles Apt. 215,,Harrisonburg,VA,22802,United States,US,1/14/20,,United States,US,VA,Harrisonburg,,
112,1/9/20 9:48pm,Bandcamp,album,Music from Saharan Cellphones,Various,USD,7.0,1.0,,7.0,,,,0.4,credit card,7.0,0.0,1257718118,,0.7,0.7,0.0,5.9,384.53,5.9,digital download,,http://sahelsounds.bandcamp.com/album/music-from-saharan-cellphones,,SS-003,889326 667889,,Dave Frey,candice88@yahoo.com,001-578-465-5308x5973,,Melissa Santiago,446 Schneider Hill Suite 025,,,,,,,,,United States,US,OH,,Bandcamp artist: sahelsounds,sahelsounds.bandcamp.com/track/tahoultine
113,1/10/20 1:21am,Bandcamp,album,Ilana: The Creator,Mdou Moctar,USD,7.0,1.0,,7.0,,,,0.57,paypal,7.0,0.0,1033257791,,0.7,0.0,0.7,0.0,384.53,5.73,digital download,,http://mdoumoctar.bandcamp.com/album/ilana-the-creator,,SS-051,602318 136893,,Joshua Roberts,petersmith@bernard.org,(526)159-0409,,Elizabeth Jones,41388 Katherine Light,,,,,,,,,United States,US,NY,Brooklyn,Bandcamp Daily: sahel-sounds-label-interview,daily.bandcamp.com/label-profile/sahel-sounds-label-interview
114,1/10/20 1:21am,Bandcamp,album,Les Filles de Illighadad,Les Filles de Illighadad,USD,7.0,1.0,,7.0,,,,,,7.0,0.0,1033257791,,0.7,1.4,0.0,12.03,396.56,6.3,digital download,,http://lesfillesdeillighadad.bandcamp.com/album/les-filles-de-illighadad,,SS-033,889326 664918,,Omar Arroyo,harriskelly@yahoo.com,843.588.3223x11016,,Jeffrey Ibarra,718 Martin Roads,,,,,,,,,United States,US,NY,Brooklyn,Recommendations footer: commonly collected,bandcamp.com/footer/cc/a257703293
115,1/10/20 6:37am,Bandcamp,album,Eghass Malan,Les Filles de Illighadad,USD,10.0,1.0,,10.0,,,,0.49,paypal,10.0,0.0,2946299361,,1.0,1.0,0.0,8.51,405.07,8.51,digital download,,http://lesfillesdeillighadad.bandcamp.com/album/eghass-malan,,SS-044,191515 928351,,Isaac Brown,james28@yahoo.com,7965158503,,Charles Gomez,510 Timothy Plains,,,,,,,,,United States,US,MD,Baltimore,,
116,1/10/20 11:41am,Bandcamp,album,Music from Saharan Cellphones,Various,USD,7.0,1.0,,7.0,1.4,,,0.54,paypal,8.4,0.0,1406369152,,0.7,0.7,0.0,5.76,410.83,5.76,digital download,,http://sahelsounds.bandcamp.com/album/music-from-saharan-cellphones,,SS-003,889326 667889,,Rebecca Hanson,hjordan@yahoo.com,+1-674-714-7007,,Eric Campbell,5124 Hannah Trafficway Apt. 094,,,,,,,,,United Kingdom,GB,West Sussex,Worthing,Bandcamp search,bandcamp.com/app/android/search
117,1/10/20 1:13pm,Bandcamp,package,Sahel Sounds Label Sampler,Various Artists,USD,20.0,1.0,,20.0,,15.0,United States,1.32,paypal,35.0,0.0,1983025656,,2.0,2.0,0.0,31.68,442.51,16.68,Sahel Sounds t-shirt,XL,http://sahelsounds.bandcamp.com/merch/sahel-sounds-t-shirt,SS-T01-BLK-UXL,,,,Melanie Brown,alyssa92@potter.biz,+1-421-815-2589x9380,Love what you guys do!,Zachary Guerra,550 Amanda Road,,London,,E5 0JS,United Kingdom,GB,1/14/20,,United Kingdom,GB,,London,Bandcamp search: “sahel sounds”,bandcamp.com/search?q=sahel%20sounds
118,1/10/20 3:18pm,Bandcamp,album,Ilana: The Creator,Mdou Moctar,USD,7.0,1.0,,7.0,1.33,,,0.54,paypal,8.33,0.0,2712873105,,0.7,0.7,0.0,5.76,448.27,5.76,digital download,,http://mdoumoctar.bandcamp.com/album/ilana-the-creator,,SS-051,602318 136893,,Lisa Carter,cindy79@pierce.com,(198)283-5465x461,,Daniel Hayes,929 Arnold Garden Apt. 307,,,,,,,,,Germany,DE,Land Berlin,Berlin,Google search,www.google.com/
119,1/10/20 4:27pm,Bandcamp,package,Ilana: The Creator,Mdou Moctar,USD,50.0,1.0,,50.0,,6.0,United States,1.36,paypal,56.0,0.0,750750297,,5.0,5.0,0.0,49.64,497.91,43.64,Ilana The Creator shirt & LP bundle,MEDIUM,http://mdoumoctar.bandcamp.com/merch/ilana-the-creator-shirt-lp-bundle,SS-051lp*-T02-W-UMD,,,,Elizabeth Harvey,burnettmartin@allen.biz,741.760.9501,,Allison Thompson,429 Williams Skyway Suite 421,3,Salt Lake City,UT,84103,United States,US,1/14/20,,United States,US,UT,Salt Lake City,Bandcamp search,bandcamp.com/app/android/search
120,1/10/20 5:12pm,Bandcamp,album,Tenere,Afous d'Afous,USD,7.0,1.0,,7.0,1.33,,,0.54,paypal,8.33,0.0,2932462159,,0.7,0.7,0.0,5.76,503.67,5.76,digital download,,http://afousdafous.bandcamp.com/album/tenere,,SS-042,191515 490421,,Allison Parrish,johnsonbrenda@gilbert-beasley.com,001-210-601-8189x2883,,Rebekah Shepherd,7553 John Drive Apt. 895,,,,,,,,,Germany,DE,Bavaria,Starnberg,Google search,www.google.com/
121,1/10/20 5:16pm,Bandcamp,album,Takamba WhatsApp 2018 EP,Tallawit Timbouctou,USD,1.0,1.0,,1.0,,,,0.11,paypal,1.0,0.0,2432320594,,0.1,0.1,0.0,0.79,504.46,0.79,digital download,,http://tallawit.bandcamp.com/album/takamba-whatsapp-2018-ep,,SS-056,602318 137098,,Ashley Moore,lance67@yahoo.com,(417)497-9116,,Jacqueline Sanders,613 Daniel View,,,,,,,,,Russia,RU,Moscow,Moscow,Google search,www.google.com/
122,1/10/20 5:16pm,Bandcamp,album,Music from Saharan Cellphones,Various,USD,25.0,1.0,,25.0,1.4,,,1.14,credit card,26.4,0.0,2470018711,,2.5,2.5,0.0,21.36,525.82,21.36,digital download,,http://sahelsounds.bandcamp.com/album/music-from-saharan-cellphones,,SS-003,889326 667889,,Jill Hale,parktara@gmail.com,(692)632-6031,,Danielle Sanders,032 Jones Walk,,,,,,,,,United Kingdom,GB,Kingston upon Hull,Hull,,
123,1/10/20 5:21pm,Bandcamp,album,Zerzura (Original Soundtrack Recording),Ahmoudou Madassane,USD,7.0,1.0,,7.0,,,,0.4,credit card,7.0,0.0,1191711528,,0.7,0.7,0.0,5.9,531.72,5.9,digital download,,http://ahmoudoumadassane.bandcamp.com/album/zerzura-original-soundtrack-recording,,SS-046,656605 382067,,Kristopher Ali,rhondacombs@hotmail.com,0286937441,,Olivia Sullivan,76563 Marquez River,,,,,,,,,United States,US,OR,Portland,,
124,1/10/20 6:03pm,shop@sahelsounds.com,payout,,,USD,,,,,,,,3.21,transfer,320.55,317.34,t250217536,0B1242824B3697258,,,,-320.55,211.17,,,,,,,,,,,,,,,,,,,,,,,,,,,,
125,1/10/20 6:03pm,shop@sahelsounds.com,payout,,,USD,,,,,,,,0.07,transfer,7.47,7.4,t250217535,1BT07055S9333630T,,,,-7.47,203.7,,,,,,,,,,,,,,,,,,,,,,,,,,,,
126,1/10/20 6:11pm,Bandcamp,album,Music from Saharan Cellphones,Various,USD,7.0,1.0,,7.0,,,,0.51,paypal,7.0,0.0,1324351799,,0.7,0.0,0.7,0.0,203.7,5.79,digital download,,http://sahelsounds.bandcamp.com/album/music-from-saharan-cellphones,,SS-003,889326 667889,,Amber Castro,robert10@hill.com,+1-197-304-5283x9752,,Carolyn Forbes,076 Davis Spur Apt. 426,,,,,,,,,United States,US,DC,Washington,t.umblr.com,t.umblr.com/
127,1/10/20 6:11pm,Bandcamp,album,Field Recordings from the Sahel,Sahel Sounds,USD,4.0,1.0,,4.0,,,,,,4.0,0.0,1324351799,,0.4,1.1,0.0,9.39,213.09,3.6,digital download,,http://sahelsounds.bandcamp.com/album/field-recordings-from-the-sahel,,SS-057,602318 137104,,Connie Lamb,kpace@lewis-gordon.com,(394)733-7943,,Danielle Cross,4638 Darrell Gardens Apt. 065,,,,,,,,,United States,US,DC,Washington,,
128,1/10/20 6:29pm,Bandcamp,package,Ilana: The Creator,Mdou Moctar,USD,30.0,1.0,,30.0,,5.0,United States,1.07,credit card,35.0,0.0,3949878252,,3.0,3.0,0.0,30.93,244.02,25.93,Ilana: The Creator shirt,Medium,http://mdoumoctar.bandcamp.com/merch/ilana-the-creator-shirt,SS-MDOU-BIRD-SHIRT-M,,,,John Sherman,alexismorales@hotmail.com,639.407.4412,,George Holloway,6412 Mark Tunnel,,Clemson,SC,29632,United States,US,1/14/20,,United States,US,SC,Clemson,Bandcamp artist: psychedelicporncrumpets,psychedelicporncrumpets.bandcamp.com
129,1/10/20 6:40pm,Bandcamp,album,Akounak Tedalat Taha Tazoughai OST,Mdou Moctar,USD,7.0,1.0,,7.0,,,,0.47,credit card,7.0,0.0,3871390480,,0.7,0.7,0.0,5.83,249.85,5.83,digital download,,http://mdoumoctar.bandcamp.com/album/akounak-tedalat-taha-tazoughai-ost,,SS-028,889326 667599,,Pamela Levy,bhenson@johnson.com,187-172-3888x849,,Sean Cordova,8159 Nathaniel Unions Apt. 471,,,,,,,,,Canada,CA,ON,Milton,Google search,www.google.com/
130,1/10/20 10:00pm,Bandcamp,album,Ilana: The Creator,Mdou Moctar,USD,10.0,1.0,,10.0,1.33,,,0.63,paypal,11.33,0.0,168885831,,1.0,1.0,0.0,8.37,258.22,8.37,digital download,,http://mdoumoctar.bandcamp.com/album/ilana-the-creator,,SS-051,602318 136893,,Dana Peterson,stantonshelby@yahoo.com,(293)826-7709x742,,Ashley Castillo,8425 Anthony Forest,,,,,,,,,Germany,DE,Bavaria,Nuremberg,Google search,www.google.de/
131,1/10/20 11:05pm,Bandcamp,album,Music from Saharan Cellphones,Various,USD,8.0,1.0,,8.0,,,,0.45,paypal,8.0,0.0,3550571906,,0.8,0.8,0.0,6.75,264.97,6.75,digital download,,http://sahelsounds.bandcamp.com/album/music-from-saharan-cellphones,,SS-003,889326 667889,,Christina George,george98@walker.com,(509)185-0279x557,,Mark Robinson,6336 Shannon View,,,,,,,,,United States,US,TX,College Station,,
132,1/11/20 12:50am,Bandcamp,package,Ilana: The Creator,Mdou Moctar,USD,15.0,1.0,,15.0,,3.0,United States,0.64,paypal,18.0,0.0,1349868885,,1.5,1.5,0.0,15.86,280.83,12.86,Ilana: The Creator CD,,http://mdoumoctar.bandcamp.com/album/ilana-the-creator,SS-051cd,SS-051,602318 136893,,Jessica Ellis,calvinclark@miller.info,939.532.0136x24198,"Your playing is phenomenal, and something the music world desperately needs right now! I’ll be looking forward to your music and keeping my ears open!",Bobby Owens,244 Jorge Wells Suite 940,,Santa Clara,CA,95051,United States,US,1/14/20,,United States,US,CA,Santa Clara,Google search,www.google.com/
133,1/11/20 1:02am,Bandcamp,album,Eghass Malan,Les Filles de Illighadad,USD,10.0,1.0,,10.0,,,,0.52,credit card,10.0,0.0,4031341413,,1.0,1.0,0.0,8.48,289.31,8.48,digital download,,http://lesfillesdeillighadad.bandcamp.com/album/eghass-malan,,SS-044,191515 928351,,Erin Osborne,lisa34@yahoo.com,+1-659-058-3553x0899,,Jared Davis,610 Lin Isle Suite 280,,,,,,,,,United States,US,CA,Concord,,
134,1/11/20 3:49am,Bandcamp,album,Houmeissa,Hama,USD,7.0,1.0,,7.0,,,,0.47,paypal,7.0,0.0,958722104,,0.7,0.7,0.0,5.83,295.14,5.83,digital download,,http://hamasynth.bandcamp.com/album/houmeissa,,SS-049,656605 382364,,Heather Porter,tony20@williams.com,+1-291-002-6883,,Michael Rivas,935 Michelle Trace Apt. 894,,,,,,,,,Australia,AU,NSW,Sydney,Bandcamp Daily: the-best-albums-of-2019-80-61,daily.bandcamp.com/best-of-2019/the-best-albums-of-2019-80-61
135,1/11/20 5:07am,Bandcamp,album,Sahel Sounds Label Sampler,Various Artists,USD,1.0,1.0,,1.0,,,,0.1,paypal,1.0,0.0,1134266987,,0.1,0.1,0.0,0.8,295.94,0.8,digital download,,http://sahelsounds.bandcamp.com/album/sahel-sounds-label-sampler,,SS-058,602318 137111,,Lindsay Irwin,nleon@gmail.com,001-803-511-0717,,Glenn Salazar,654 Brandon Spring Suite 514,,,,,,,,,United States,US,PA,Philadelphia,sahelsounds.com,sahelsounds.com/
136,1/11/20 8:11am,Bandcamp,album,Ilana: The Creator,Mdou Moctar,USD,7.0,1.0,,7.0,,,,0.76,paypal,7.0,0.0,3193277079,,0.7,0.0,0.7,0.0,295.94,5.54,digital download,,http://mdoumoctar.bandcamp.com/album/ilana-the-creator,,SS-051,602318 136893,,Whitney Davis,ztate@yahoo.com,003-616-0954,,Danielle Green,3354 Clark Garden,,,,,,,,,United States,US,CA,Oakland,,
137,1/11/20 8:11am,Bandcamp,album,Afelan,Mdou Moctar,USD,7.0,1.0,,7.0,,,,,,7.0,0.0,3193277079,,0.7,0.0,1.4,0.0,295.94,6.3,digital download,,http://mdoumoctar.bandcamp.com/album/afelan,,SS-017,889326 664840,,Anna Diaz,chaseheather@hotmail.com,0002333333,,Michael Lewis,9296 Johnson Courts Suite 034,,,,,,,,,United States,US,CA,Oakland,,
138,1/11/20 8:11am,Bandcamp,album,Sahel Sounds Label Sampler,Various Artists,USD,10.0,1.0,,10.0,,,,,,10.0,0.0,3193277079,,1.0,2.4,0.0,20.84,316.78,9.0,digital download,,http://sahelsounds.bandcamp.com/album/sahel-sounds-label-sampler,,SS-058,602318 137111,,Scott Stone,james19@ramirez-rangel.org,166.290.5169,,Dan White,728 Brenda Mall Suite 656,,,,,,,,,United States,US,CA,Oakland,,
139,1/11/20 8:44am,Bandcamp,album,Les Filles de Illighadad,Les Filles de Illighadad,USD,7.0,1.0,,7.0,,,,0.4,paypal,7.0,0.0,832856973,,0.7,0.7,0.0,5.9,322.68,5.9,digital download,,http://lesfillesdeillighadad.bandcamp.com/album/les-filles-de-illighadad,,SS-033,889326 664918,,Kelsey Henry,wilsonerica@gmail.com,001-081-533-8205x398,,Michael Lewis,551 Woods Hills Suite 245,,,,,,,,,United States,US,CA,Oakland,,
140,1/11/20 11:35am,Bandcamp,album,Ilana: The Creator,Mdou Moctar,USD,10.0,1.0,,10.0,1.4,,,0.63,paypal,11.4,0.0,8396143,,1.0,1.0,0.0,8.37,331.05,8.37,digital download,,http://mdoumoctar.bandcamp.com/album/ilana-the-creator,,SS-051,602318 136893,,Brian Baker,ksuarez@hotmail.com,177-212-8392x9164,,Sandra Foster,997 Yolanda Courts,,,,,,,,,United Kingdom,GB,Lancashire,Preston,,
141,1/11/20 11:50am,Bandcamp,album,Ilana: The Creator,Mdou Moctar,USD,8.0,1.0,,8.0,,,,0.45,credit card,8.0,0.0,397879041,,0.8,0.8,0.0,6.75,337.8,6.75,digital download,,http://mdoumoctar.bandcamp.com/album/ilana-the-creator,,SS-051,602318 136893,,Jeremy Clark,gregorykendra@hotmail.com,001-021-836-2651,,Kevin Rodriguez,68357 Oneal Throughway Suite 052,,,,,,,,,United States,US,NY,Lockport,,
142,1/11/20 1:51pm,Bandcamp,album,Music from Saharan Cellphones: Volume 2,Various,USD,7.0,1.0,,7.0,,,,0.4,paypal,7.0,0.0,1697191782,,0.7,0.7,0.0,5.9,343.7,5.9,digital download,,http://sahelsounds.bandcamp.com/album/music-from-saharan-cellphones-volume-2,,SS-012,889326 667742,,Kayla Wright,ericelliott@price.com,496-503-7962x164,,Kimberly Cardenas,619 Erin Rapid,,,,,,,,,United States,US,NJ,Pine Brook,shop.sahelsounds.com,shop.sahelsounds.com/collections/musics
143,1/11/20 1:52pm,Bandcamp,album,Music from Saharan Cellphones,Various,USD,7.0,1.0,,7.0,,,,0.4,paypal,7.0,0.0,179160660,,0.7,0.7,0.0,5.9,349.6,5.9,digital download,,http://sahelsounds.bandcamp.com/album/music-from-saharan-cellphones,,SS-003,889326 667889,,Michael Nguyen,booneross@young-ryan.net,001-917-944-4064x66335,,Maurice Whitney,1342 Stafford Court,,,,,,,,,United States,US,NJ,Pine Brook,,
144,1/11/20 2:01pm,Bandcamp,package,Ilana: The Creator,Mdou Moctar,USD,15.0,1.0,,15.0,,10.0,United States,1.03,paypal,25.0,0.0,3864374991,,1.5,1.5,0.0,22.47,372.07,12.47,Ilana: The Creator CD,,http://mdoumoctar.bandcamp.com/album/ilana-the-creator,SS-051cd,SS-051,602318 136893,,Teresa Gomez,fwong@gmail.com,629.427.2480,,Miranda Williams,206 Juarez Forest,,kaatsheuvel,brabant,5171wx,Netherlands,NL,1/14/20,,Netherlands,NL,brabant,kaatsheuvel,,
145,1/11/20 3:37pm,Bandcamp,album,Ilana: The Creator,Mdou Moctar,USD,7.0,1.0,,7.0,,,,0.47,credit card,7.0,0.0,3893215313,,0.7,0.7,0.0,5.83,377.9,5.83,digital download,,http://mdoumoctar.bandcamp.com/album/ilana-the-creator,,SS-051,602318 136893,,Chad Fields,dana67@olson.com,370.070.0668x645,,Karen Hanson,29738 Smith Valley,,,,,,,,,Canada,CA,ON,Toronto,Google search,www.google.com/
146,1/11/20 4:23pm,Bandcamp,album,Balani Show Super Hits: Electronic Street Parties from Mali,Various,USD,7.0,1.0,,7.0,1.4,,,0.57,credit card,8.4,0.0,2910404537,,0.7,0.7,0.0,5.73,383.63,5.73,digital download,,http://sahelsounds.bandcamp.com/album/balani-show-super-hits-electronic-street-parties-from-mali,,SS-021,889326 667643,,Russell Roberson,marshalldenise@gmail.com,267-042-5024,,Jacob Gray,33659 Jones Estate,,,,,,,,,France,FR,Upper Garonne,Toulouse,Google search,www.google.com/
147,1/11/20 5:18pm,Bandcamp,album,Ilana: The Creator,Mdou Moctar,USD,7.0,1.0,,7.0,1.33,,,0.54,paypal,8.33,0.0,2630668617,,0.7,0.7,0.0,5.76,389.39,5.76,digital download,,http://mdoumoctar.bandcamp.com/album/ilana-the-creator,,SS-051,602318 136893,,Julie Thomas,jerry29@giles-lee.info,519-572-1538,,Natalie Foster,1069 Anthony Union,,,,,,,,,Germany,DE,Hesse,Frankfurt am Main,Google search,www.google.com/
148,1/11/20 6:02pm,shop@sahelsounds.com,payout,,,USD,,,,,,,,0.13,transfer,12.59,12.46,t250501929,5519173628723501Y,,,,-12.59,376.8,,,,,,,,,,,,,,,,,,,,,,,,,,,,
149,1/11/20 6:03pm,shop@sahelsounds.com,payout,,,USD,,,,,,,,1.91,transfer,191.11,189.2,t250501930,3T278532TR980762C,,,,-191.11,185.69,,,,,,,,,,,,,,,,,,,,,,,,,,,,
150,1/11/20 6:05pm,Bandcamp,album,Music from Saharan Cellphones,Various,USD,10.0,1.0,,10.0,,,,0.49,paypal,10.0,0.0,2073742225,,1.0,1.0,0.0,8.51,194.2,8.51,digital download,,http://sahelsounds.bandcamp.com/album/music-from-saharan-cellphones,,SS-003,889326 667889,,Gary Wright,jacqueline41@yahoo.com,709-062-4869x4904,,Jeremy Maxwell,813 Stuart Track,,,,,,,,,United States,US,TX,San Antonio,,
151,1/11/20 9:15pm,Bandcamp,album,Waande Kadde,Amadou Binta Konté and Tidiane Thiam,USD,10.0,1.0,,10.0,,,,0.52,credit card,10.0,0.0,1213111523,,1.0,1.0,0.0,8.48,202.68,8.48,digital download,,http://sahelsounds.bandcamp.com/album/waande-kadde,,SS-036 / SFH-01,889326 796008,,Mark Evans,kellybarron@craig.info,+1-575-484-8797x118,,Tammy Thompson,0776 Ana Summit Apt. 324,,,,,,,,,United States,US,OR,Portland,,
152,1/11/20 10:18pm,Bandcamp,package,Eghass Malan,Les Filles de Illighadad,USD,13.0,1.0,,13.0,,14.0,United States,1.16,credit card,27.0,0.0,813561096,,1.3,1.3,0.0,24.54,227.22,10.54,'Eghass Malan' compact disc,,http://lesfillesdeillighadad.bandcamp.com/album/eghass-malan,SS-044cd-1,SS-044,191515 928351,,David Aguirre,ashley50@hotmail.com,+1-004-359-2587,,Tony Le,223 Ferguson Gardens Suite 460,,Dublin 18,Leinster,D18AR20,Ireland,IE,1/14/20,,Ireland,IE,Leinster,Dublin 18,,
153,1/11/20 11:20pm,Bandcamp,package,Hali Diallo,Tallawit Timbouctou,USD,17.0,1.0,,17.0,,2.0,United States,2.16,paypal,19.0,0.0,1894423560,,1.7,0.0,1.7,0.0,227.22,13.14,Vinyl LP,,http://tallawit.bandcamp.com/album/hali-diallo,SS-048lp,SS-048,656605 382265,,Joseph Flores,rose84@davis-lopez.com,+1-739-651-4772,,Edward James,7242 Lori Manor,,Warrenton,VA,20186,United States,US,1/14/20,,United States,US,VA,Warrenton,,
154,1/11/20 11:20pm,Bandcamp,package,Akounak Tedalat Taha Tazoughai OST,Mdou Moctar,USD,17.0,1.0,,17.0,,2.0,United States,,,19.0,0.0,1894423560,,1.7,0.0,3.4,0.0,227.22,15.3,Akounak OST LP,,http://mdoumoctar.bandcamp.com/album/akounak-tedalat-taha-tazoughai-ost,SS-028lp-1,SS-028,889326 667599,,Ashley Sanchez,malexander@hunt.biz,194.898.3530x4375,,Carla Welch,163 Crystal Crossing,,Warrenton,VA,20186,United States,US,1/14/20,,United States,US,VA,Warrenton,,
155,1/11/20 11:20pm,Bandcamp,package,Afelan,Mdou Moctar,USD,17.0,1.0,,17.0,,2.0,United States,,,19.0,0.0,1894423560,,1.7,0.0,5.1,0.0,227.22,15.3,Afelan LP,,http://mdoumoctar.bandcamp.com/album/afelan,SS-017lp,SS-017,889326 664840,,John Merritt,mcgeesheila@hotmail.com,(764)973-7384,,Anthony Terry,4897 Stone Expressway Suite 065,,Warrenton,VA,20186,United States,US,1/14/20,,United States,US,VA,Warrenton,,
156,1/11/20 11:20pm,Bandcamp,package,Anou Malane,Abdallah Ag Oumbadougou,USD,17.0,1.0,,17.0,,5.0,United States,,,22.0,0.0,1894423560,,1.7,0.0,6.8,0.0,227.22,15.3,Vinyl,,http://abdallahagoumbadougou.bandcamp.com/album/anou-malane,SS-053lp,SS-053,602318 136992,,Courtney Hill,ulawrence@swanson.org,(003)955-2225,,Michael Stewart,12574 Watson Terrace Suite 081,,Warrenton,VA,20186,United States,US,1/14/20,,United States,US,VA,Warrenton,,
157,1/11/20 11:20pm,Bandcamp,package,Falaw,Luka Productions,USD,17.0,1.0,,17.0,,2.0,United States,,,19.0,0.0,1894423560,,1.7,8.5,0.0,87.34,314.56,15.3,Limited Edition Vinyl,,http://lukaproductions.bandcamp.com/album/falaw,SS-052lp,SS-052,602318 136855,,Johnathan Ross,vincent68@baker.org,(986)951-1126,,Cory Brown,1977 Pearson Dale,,Warrenton,VA,20186,United States,US,1/14/20,,United States,US,VA,Warrenton,,
158,1/12/20 2:02am,Bandcamp,album,Ilana: The Creator,Mdou Moctar,USD,7.0,1.0,,7.0,,,,0.4,paypal,7.0,0.0,4117512783,,0.7,0.7,0.0,5.9,320.46,5.9,digital download,,http://mdoumoctar.bandcamp.com/album/ilana-the-creator,,SS-051,602318 136893,,Sara Hudson,rebecca89@sanchez.info,001-606-219-2322x60558,,Kayla Mccoy,317 Steven Plains Suite 778,,,,,,,,,United States,US,NJ,Secaucus,,
159,1/12/20 3:37am,Bandcamp,package,Ilana: The Creator,Mdou Moctar,USD,12.0,1.0,,12.0,,2.0,United States,0.98,paypal,14.0,0.0,1051907331,,1.2,0.0,1.2,0.0,320.46,9.82,Ilana: The Creator CD,,http://mdoumoctar.bandcamp.com/album/ilana-the-creator,SS-051cd,SS-051,602318 136893,,Christopher Robinson,hbrown@lee.net,001-407-742-6042,,Mary Dawson,141 Brown Brooks,,Victoria,TX,77904,United States,US,1/14/20,,United States,US,TX,Victoria,Bandcamp home page,bandcamp.com/
160,1/12/20 3:37am,Bandcamp,package,Ilana: The Creator,Mdou Moctar,USD,17.0,1.0,,17.0,,5.0,United States,,,22.0,0.0,1051907331,,1.7,2.9,0.0,32.12,352.58,15.3,Ilana LP,,http://mdoumoctar.bandcamp.com/album/ilana-the-creator,SS-051lp,SS-051,602318 136893,,John Gilbert,jeffreylane@gmail.com,491.374.0318x8608,,Stephanie Chang,613 Branch Port,,Victoria,TX,77904,United States,US,1/14/20,,United States,US,TX,Victoria,Bandcamp home page,bandcamp.com/
161,1/12/20 3:38am,Bandcamp,package,Ilana: The Creator,Mdou Moctar,USD,17.0,1.0,,17.0,,5.0,United States,0.72,paypal,22.0,0.0,414524060,,1.7,1.7,0.0,19.58,372.16,14.58,Ilana LP,,http://mdoumoctar.bandcamp.com/album/ilana-the-creator,SS-051lp,SS-051,602318 136893,,Eric Hall,daltonandrews@yahoo.com,166-652-2118x66074,,Heidi Lynch,436 Debra Grove Apt. 357,,Warrenton,VA,20186,United States,US,1/14/20,,United States,US,VA,Warrenton,Bing: “mdou moctar”,www.bing.com/search?q=mdou+moctar
162,1/12/20 4:45am,Bandcamp,package,No. 1,Etran de L'Aïr,USD,17.0,1.0,,17.0,,2.0,United States,1.08,paypal,19.0,0.0,3948866938,,1.7,0.0,1.7,0.0,372.16,14.22,Limited Edition LP,,http://etrandelair.bandcamp.com/album/no-1,SS-045lp,SS-045,602318 136824,,Laura Stephens,krausekenneth@trevino.com,001-491-439-3430,,Mark Brewer,099 Amanda Ferry,,Warrenton,VA,20186,United States,US,1/14/20,,United States,US,VA,Warrenton,,
163,1/12/20 4:45am,Bandcamp,package,Eghass Malan,Les Filles de Illighadad,USD,17.0,1.0,,17.0,,5.0,United States,,,22.0,0.0,3948866938,,1.7,3.4,0.0,36.52,408.68,15.3,'Eghass Malan' LP,,http://lesfillesdeillighadad.bandcamp.com/album/eghass-malan,SS-044lp-1,SS-044,191515 928351,,Sarah Marquez,karen16@pena.net,(378)502-3955x46876,,Kyle Johnson,164 Jerry Stravenue Apt. 347,,Warrenton,VA,20186,United States,US,1/14/20,,United States,US,VA,Warrenton,,
164,1/12/20 5:30am,Bandcamp,album,Ilana: The Creator,Mdou Moctar,USD,7.0,1.0,,7.0,,,,0.47,credit card,7.0,0.0,3279601207,,0.7,0.7,0.0,5.83,414.51,5.83,digital download,,http://mdoumoctar.bandcamp.com/album/ilana-the-creator,,SS-051,602318 136893,,Tyler Salinas,anna74@christian.com,+1-722-935-0749,,Bethany Blanchard,03723 James Underpass Suite 100,,,,,,,,,South Africa,ZA,Western Cape,Cape Town,Bandcamp artist: guidedbyvoices,guidedbyvoices.bandcamp.com/album/zeppelin-over-china
165,1/12/20 5:41am,Bandcamp,package,Eghass Malan,Les Filles de Illighadad,USD,17.0,1.0,,17.0,,5.0,United States,0.72,paypal,22.0,0.0,237534592,,1.7,1.7,0.0,19.58,434.09,14.58,'Eghass Malan' LP,,http://lesfillesdeillighadad.bandcamp.com/album/eghass-malan,SS-044lp-1,SS-044,191515 928351,,Karen Smith,amycunningham@yahoo.com,427-948-3771,,Jesse Roberts,00609 Carlson Walk Suite 960,2B,New York,NY,10003,United States,US,1/14/20,,United States,US,NY,New York,,
166,1/12/20 1:14pm,Bandcamp,package,Ilana: The Creator,Mdou Moctar,USD,18.0,2.0,,36.0,,24.0,United States,2.22,credit card,60.0,0.0,833030782,,3.6,3.6,0.0,54.18,488.27,30.18,Ilana LP,,http://mdoumoctar.bandcamp.com/album/ilana-the-creator,SS-051lp,SS-051,602318 136893,,Mark Arnold,tmiller@adams-weaver.info,0177994562,,Michael Morris,025 Beverly Garden Suite 207,,Düsseldorf,,40477,Germany,DE,1/14/20,,Germany,DE,,Düsseldorf,Google search,www.google.com/
167,1/12/20 2:32pm,Bandcamp,album,Ilana: The Creator,Mdou Moctar,USD,7.0,1.0,,7.0,1.33,,,0.57,credit card,8.33,0.0,3208909367,,0.7,0.7,0.0,5.73,494.0,5.73,digital download,,http://mdoumoctar.bandcamp.com/album/ilana-the-creator,,SS-051,602318 136893,,Eric Lee,greerjessica@harris.org,(123)453-9983,,Christopher Fisher,23540 Steven Views,,,,,,,,,Germany,DE,Hamburg,Hamburg,ecosia.org,www.ecosia.org/
168,1/12/20 6:02pm,shop@sahelsounds.com,payout,,,USD,,,,,,,,0.49,transfer,49.49,49.0,t250732012,8KH16396WA461814T,,,,-49.49,444.51,,,,,,,,,,,,,,,,,,,,,,,,,,,,
169,1/12/20 6:02pm,shop@sahelsounds.com,payout,,,USD,,,,,,,,1.36,transfer,136.2,134.84,t250732014,8AU4353918355524J,,,,-136.2,308.31,,,,,,,,,,,,,,,,,,,,,,,,,,,,
170,1/12/20 8:32pm,Bandcamp,album,Sousoume Tamachek,Mdou Moctar,USD,7.0,1.0,,7.0,1.75,,,0.86,credit card,8.75,0.0,746908751,,0.7,0.0,0.7,0.0,308.31,5.44,digital download,,http://mdoumoctar.bandcamp.com/album/sousoume-tamachek,,SS-043,191515 769435,,Jennifer Bailey,bruce90@ramos-miller.biz,001-378-818-2155x511,,Lisa Ellis,1688 Morrow Lane,,,,,,,,,Denmark,DK,Central Jutland,Sunds,Google search,www.google.com/
171,1/12/20 8:32pm,Bandcamp,album,Ilana: The Creator,Mdou Moctar,USD,7.0,1.0,,7.0,1.75,,,,,8.75,0.0,746908751,,0.7,1.4,0.0,11.74,320.05,6.3,digital download,,http://mdoumoctar.bandcamp.com/album/ilana-the-creator,,SS-051,602318 136893,,Joshua Bennett,katherine97@miller.biz,821-129-7090,,Ruben Brown,29470 Herrera Plain,,,,,,,,,Denmark,DK,Central Jutland,Sunds,Bandcamp fan wishlist,bandcamp.com/celestialslug
172,1/12/20 9:37pm,Bandcamp,package,Ilana: The Creator,Mdou Moctar,USD,17.0,1.0,,17.0,,5.0,United States,0.78,credit card,22.0,0.0,4081831450,,1.7,1.7,0.0,19.52,339.57,14.52,Ilana LP,,http://mdoumoctar.bandcamp.com/album/ilana-the-creator,SS-051lp,SS-051,602318 136893,,Terri Hall,christinasmith@cain.biz,973.611.8485,,Melissa Walker,634 Cassandra Stream,,Burnsville,MN,55337,United States,US,1/14/20,,United States,US,MN,Burnsville,Google search,www.google.com/
173,1/12/20 11:26pm,Bandcamp,package,Ilana: The Creator,Mdou Moctar,USD,17.0,1.0,,17.0,,5.0,United States,0.72,paypal,22.0,0.0,3228302444,,1.7,1.7,0.0,19.58,359.15,14.58,Ilana LP,,http://mdoumoctar.bandcamp.com/album/ilana-the-creator,SS-051lp,SS-051,602318 136893,,Beth Howard,lynnvaughn@gmail.com,052-270-8690,,Leslie York,8123 Green Inlet,,Greenbrier,TN,37073,United States,US,1/14/20,,United States,US,TN,Greenbrier,Google search,www.google.com/
174,1/13/20 12:46am,Bandcamp,package,Sahel Sounds Label Sampler,Various Artists,USD,20.0,1.0,,20.0,,5.0,United States,0.78,paypal,25.0,0.0,2607133501,,2.0,2.0,0.0,22.22,381.37,17.22,Sahel Sounds t-shirt,Medium,http://sahelsounds.bandcamp.com/merch/sahel-sounds-t-shirt,SS-T01-BLK-UMD,,,,Marisa Pierce,ccooper@hotmail.com,+1-617-437-6894x06384,,Tammy Davis,306 Michelle Land,,Austin,TX,78745,United States,US,1/14/20,,United States,US,TX,Austin,,
175,1/13/20 2:20am,Bandcamp,album,Ilana: The Creator,Mdou Moctar,USD,8.0,1.0,,8.0,,,,0.45,paypal,8.0,0.0,747398875,,0.8,0.8,0.0,6.75,388.12,6.75,digital download,,http://mdoumoctar.bandcamp.com/album/ilana-the-creator,,SS-051,602318 136893,,Michael Cox,david11@harper.info,001-555-771-8662x62923,,Jenny Vance,2280 Wallace Parkway Apt. 090,,,,,,,,,United States,US,NJ,Rockaway,duckduckgo.com,duckduckgo.com/
176,1/13/20 3:40am,Bandcamp,package,Afelan,Mdou Moctar,USD,17.0,1.0,,17.0,,5.0,United States,0.72,paypal,22.0,0.0,1030043842,,1.7,1.7,0.0,19.58,407.7,14.58,Afelan LP,,http://mdoumoctar.bandcamp.com/album/afelan,SS-017lp,SS-017,889326 664840,,Misty Dennis,jbell@yahoo.com,(131)177-7939,,Calvin Brown,5715 Williams Glens,15,Santa Cruz,CA,95062,United States,US,1/14/20,,United States,US,CA,Santa Cruz,Bandcamp music feed,http://blog.bandcamp.com/2014/01/30/bandcamp-app-now-with-music-feed/
177,1/13/20 3:49am,Bandcamp,album,Sousoume Tamachek,Mdou Moctar,USD,7.0,1.0,,7.0,,,,0.4,paypal,7.0,0.0,3350033883,,0.7,0.7,0.0,5.9,413.6,5.9,digital download,,http://mdoumoctar.bandcamp.com/album/sousoume-tamachek,,SS-043,191515 769435,,Michael Davila,travishernandez@robinson.com,242-825-7925,,Jamie Mckenzie,3893 Susan Courts,,,,,,,,,United States,US,CA,Sacramento,Bandcamp music feed,http://blog.bandcamp.com/2014/01/30/bandcamp-app-now-with-music-feed/
178,1/13/20 3:56am,Bandcamp,package,Eghass Malan,Les Filles de Illighadad,USD,17.0,1.0,,17.0,,5.0,United States,0.72,paypal,22.0,0.0,1528369628,,1.7,1.7,0.0,19.58,433.18,14.58,'Eghass Malan' LP,,http://lesfillesdeillighadad.bandcamp.com/album/eghass-malan,SS-044lp-1,SS-044,191515 928351,,Victoria Flores,arandolph@yahoo.com,(744)047-4704x493,,Nathaniel Sampson,61929 Kennedy Creek Suite 060,15,Santa Cruz,CA,95062,United States,US,1/14/20,,United States,US,CA,Santa Cruz,Bandcamp music feed,http://blog.bandcamp.com/2014/01/30/bandcamp-app-now-with-music-feed/
179,1/13/20 3:59am,Bandcamp,package,Ilana: The Creator,Mdou Moctar,USD,17.0,1.0,,17.0,,5.0,United States,0.72,paypal,22.0,0.0,2051114425,,1.7,1.7,0.0,19.58,452.76,14.58,Ilana LP,,http://mdoumoctar.bandcamp.com/album/ilana-the-creator,SS-051lp,SS-051,602318 136893,,Allen Russell,duartejudith@middleton.com,221.836.2166x2555,,Laura Krause,1037 David Summit,,Newnan,GA,30265,United States,US,1/14/20,,United States,US,GA,Newnan,Google search,www.google.com/
180,1/13/20 4:00am,Bandcamp,package,Les Filles de Illighadad,Les Filles de Illighadad,USD,17.0,2.0,,34.0,,7.0,United States,1.08,paypal,41.0,0.0,1607134683,,3.4,3.4,0.0,36.52,489.28,29.52,Les Filles de Illighadad LP,,http://lesfillesdeillighadad.bandcamp.com/album/les-filles-de-illighadad,SS-033-LP,SS-033,889326 664918,,Joseph Wagner,zjuarez@gmail.com,100-980-9432x4959,,Annette Gallegos,0200 Gibson Point,15,Santa Cruz,CA,95062,United States,US,1/14/20,,United States,US,CA,Santa Cruz,Bandcamp app discover,bandcamp.com/app/android/discover
181,1/13/20 5:20am,Bandcamp,package,Afelan,Mdou Moctar,USD,17.0,1.0,,17.0,,23.0,United States,1.46,paypal,40.0,0.0,497979077,,1.7,1.7,0.0,36.84,526.12,13.84,Afelan LP,,http://mdoumoctar.bandcamp.com/album/afelan,SS-017lp,SS-017,889326 664840,,Sherry Wright,mallen@zimmerman.com,(097)550-7523,,Logan Price,1735 Tran Manors Suite 861,,Perth,WA,6018,Australia,AU,1/14/20,,Australia,AU,WA,Perth,Bandcamp artist: mdoumoctar,mdoumoctar.bandcamp.com/album/afelan
182,1/13/20 6:07am,Bandcamp,album,Ilana: The Creator,Mdou Moctar,USD,10.0,1.0,,10.0,,,,0.52,credit card,10.0,0.0,477802898,,1.0,1.0,0.0,8.48,534.6,8.48,digital download,,http://mdoumoctar.bandcamp.com/album/ilana-the-creator,,SS-051,602318 136893,,Patrick Carlson,zray@benson-swanson.org,001-404-489-1155x502,,Cindy Gordon,360 Moore Forks Suite 195,,,,,,,,,United States,US,CA,Oakland,Bandcamp artist: mdoumoctar,mdoumoctar.bandcamp.com/track/tarhatazed
183,1/13/20 8:25am,Bandcamp,album,Ilana: The Creator,Mdou Moctar,USD,7.0,1.0,,7.0,,,,0.47,paypal,7.0,0.0,3915029592,,0.7,0.7,0.0,5.83,540.43,5.83,digital download,,http://mdoumoctar.bandcamp.com/album/ilana-the-creator,,SS-051,602318 136893,,Jill Reeves,eadams@alvarado.com,740-728-2795x8437,,Kristen Mccann,627 Kathryn Course Apt. 190,,,,,,,,,Australia,AU,VIC,Melbourne,rateyourmusic.com (embedded player),rateyourmusic.com/release/album/mdou-moctar/ilana-the-creator/
184,1/13/20 12:57pm,Bandcamp,album,Music from Saharan Cellphones,Various,USD,7.0,1.0,,7.0,1.4,,,0.54,gift card,8.4,0.0,942769193,,0.7,0.7,0.0,5.76,546.19,5.76,digital download,,http://sahelsounds.bandcamp.com/album/music-from-saharan-cellphones,,SS-003,889326 667889,,Brandi Wright,kimberlygarcia@gmail.com,001-094-484-2547x170,,Mark Huber,7417 Nicole View,,,,,,,,,United Kingdom,GB,Greenwich,Greenwich,Bandcamp artist: sahelsounds,sahelsounds.bandcamp.com/album/music-from-saharan-cellphones
185,1/13/20 6:02pm,shop@sahelsounds.com,payout,,,USD,,,,,,,,0.12,transfer,11.73,11.61,t250954581,1P5885215U874760K,,,,-11.73,534.46,,,,,,,,,,,,,,,,,,,,,,,,,,,,
186,1/13/20 6:02pm,shop@sahelsounds.com,payout,,,USD,,,,,,,,2.97,transfer,296.58,293.61,t250954583,6AJ66631JM361601F,,,,-296.58,237.88,,,,,,,,,,,,,,,,,,,,,,,,,,,,
187,1/13/20 6:14pm,Bandcamp,album,Waande Kadde,Amadou Binta Konté and Tidiane Thiam,USD,7.0,1.0,,7.0,1.4,,,0.57,credit card,8.4,0.0,1414330179,,0.7,0.7,0.0,5.73,243.61,5.73,digital download,,http://sahelsounds.bandcamp.com/album/waande-kadde,,SS-036 / SFH-01,889326 796008,,Scott Dawson,huffmanuel@mercer.com,500-962-8496x85844,,Jessica Mcdonald,810 Scott Valley,,,,,,,,,United Kingdom,GB,Haringey,Hornsey,Bandcamp fan page: totalvibration,bandcamp.com/totalvibration
188,1/13/20 7:00pm,Bandcamp,album,Ilana: The Creator,Mdou Moctar,USD,8.0,1.0,,8.0,1.33,,,0.57,paypal,9.33,0.0,902582479,,0.8,0.8,0.0,6.63,250.24,6.63,digital download,,http://mdoumoctar.bandcamp.com/album/ilana-the-creator,,SS-051,602318 136893,,Janice Beasley,dcooper@hotmail.com,158-180-2483x45970,,Richard Sims,5424 Gutierrez Forges Suite 610,,,,,,,,,Germany,DE,Hesse,Geisenheim,Bandcamp search,bandcamp.com/app/android/search
189,1/13/20 7:28pm,Bandcamp,package,Ilana: The Creator,Mdou Moctar,USD,30.0,1.0,,30.0,,5.0,United States,0.97,paypal,35.0,0.0,2882295978,,3.0,3.0,0.0,31.03,281.27,26.03,Ilana: The Creator shirt,Large,http://mdoumoctar.bandcamp.com/merch/ilana-the-creator-shirt,SS-MDOU-BIRD-SHIRT-L,,,,Donald Wagner,allisonchambers@phillips.com,(494)028-9737x2815,,Shelby Ashley,9208 Harrington Mall,16070 Rainbow Drive,Cobb,CA,95426-0136,United States,US,1/14/20,,United States,US,CA,Cobb,"Bandcamp search: “ilana, the creator”",bandcamp.com/search?q=Ilana%2C%20the%20creator
190,1/13/20 8:57pm,Bandcamp,package,Sahel Sounds Label Sampler,Various Artists,USD,20.0,1.0,,20.0,,5.0,United States,0.78,paypal,25.0,0.0,3151107767,,2.0,2.0,0.0,22.22,303.49,17.22,Sahel Sounds t-shirt,Medium,http://sahelsounds.bandcamp.com/merch/sahel-sounds-t-shirt,SS-T01-BLK-UMD,,,,Kyle Rivera,jillwu@hotmail.com,(965)861-7523x9113,,Anthony Kaufman,4405 Williams Canyon,,Encino,CA,91316,United States,US,1/14/20,,United States,US,CA,Encino,,
191,1/13/20 10:25pm,Bandcamp,package,Houmeissa,Hama,USD,17.0,1.0,,17.0,,5.0,United States,0.72,paypal,22.0,0.0,3386181204,,1.7,1.7,0.0,19.58,323.07,14.58,Hama - Houmeissa LP,,http://hamasynth.bandcamp.com/album/houmeissa,SS-049lp,SS-049,656605 382364,,Tim Phillips,jodi99@yahoo.com,(669)171-0488,,Michael Stark,3319 Valentine Plaza Suite 615,,Grantham,NH,3753,United States,US,1/14/20,,United States,US,NH,Grantham,Twitter,t.co/YNgmDGS3F5?amp=1
192,1/14/20 12:18am,Bandcamp,album,No. 1,Etran de L'Aïr,USD,7.0,1.0,,7.0,1.4,,,0.54,paypal,8.4,0.0,3011962878,,0.7,0.7,0.0,5.76,328.83,5.76,digital download,,http://etrandelair.bandcamp.com/album/no-1,,SS-045,602318 136824,,Lisa Murray,mjones@hotmail.com,001-183-261-7644x8017,,Valerie Manning,67223 Donna Pine,,,,,,,,,United Kingdom,GB,Waltham Forest,Leyton,Bandcamp search,bandcamp.com/app/ios/search
193,1/14/20 1:06am,Bandcamp,album,Music from Saharan Cellphones,Various,USD,7.0,1.0,,7.0,,,,0.61,credit card,7.0,0.0,1195225944,,0.7,0.0,0.7,0.0,328.83,5.69,digital download,,http://sahelsounds.bandcamp.com/album/music-from-saharan-cellphones,,SS-003,889326 667889,,Dylan Smith,jose73@gmail.com,218.939.1509x94240,,Andrew Johnson,66493 Emily Prairie,,,,,,,,,United States,US,NH,Littleton,t.umblr.com,t.umblr.com/
194,1/14/20 1:06am,Bandcamp,album,Music from Saharan Cellphones: Volume 2,Various,USD,7.0,1.0,,7.0,,,,,,7.0,0.0,1195225944,,0.7,1.4,0.0,11.99,340.82,6.3,digital download,,http://sahelsounds.bandcamp.com/album/music-from-saharan-cellphones-volume-2,,SS-012,889326 667742,,Joseph Williams,nicholas04@hill-scott.com,001-848-809-6774,,Stacy Le,10711 Curry Plains,,,,,,,,,United States,US,NH,Littleton,Google search,www.google.com/
195,1/14/20 2:33am,Bandcamp,album,Music from Saharan Cellphones,Various,USD,7.0,1.0,,7.0,,,,0.4,paypal,7.0,0.0,2985005935,,0.7,0.7,0.0,5.9,346.72,5.9,digital download,,http://sahelsounds.bandcamp.com/album/music-from-saharan-cellphones,,SS-003,889326 667889,,Christopher Thompson,wsalazar@gmail.com,+1-923-327-5171,,Destiny Scott,067 Brian Viaduct Apt. 326,,,,,,,,,United States,US,CA,North Hollywood,,
196,1/14/20 8:54am,Bandcamp,album,Ilana: The Creator,Mdou Moctar,USD,10.0,1.0,,10.0,1.4,,,0.63,paypal,11.4,0.0,2567601167,,1.0,1.0,0.0,8.37,355.09,8.37,digital download,,http://mdoumoctar.bandcamp.com/album/ilana-the-creator,,SS-051,602318 136893,,Sherry Carson,dclark@jones-jones.com,+1-842-571-2091,,Marcus Walker,02138 Kennedy Valley,,,,,,,,,United Kingdom,GB,,,Bandcamp search,bandcamp.com/app/android/search
197,1/14/20 9:13am,Bandcamp,package,Ilana: The Creator,Mdou Moctar,USD,12.0,1.0,,12.0,,10.0,United States,1.0,credit card,22.0,0.0,11072729,,1.2,1.2,0.0,19.8,374.89,9.8,Ilana: The Creator CD,,http://mdoumoctar.bandcamp.com/album/ilana-the-creator,SS-051cd,SS-051,602318 136893,,Samantha Orozco,fdavis@hotmail.com,001-577-672-4295x90702,,Benjamin Peterson,06649 Williamson Crest Apt. 974,,Zakopane,Malopolska,34-500,Poland,PL,1/14/20,,Poland,PL,Malopolska,Zakopane,Google search,www.google.com/
198,1/14/20 3:29pm,Bandcamp,album,Eghass Malan,Les Filles de Illighadad,USD,7.0,1.0,,7.0,,,,0.47,credit card,7.0,0.0,2343999342,,0.7,0.7,0.0,5.83,380.72,5.83,digital download,,http://lesfillesdeillighadad.bandcamp.com/album/eghass-malan,,SS-044,191515 928351,,Christine Williams,garciacrystal@gmail.com,550-421-3835,,Kimberly Garcia,7942 Mark Mountain,,,,,,,,,Mexico,MX,Puebla,Puebla City,Bandcamp Discover,bandcamp.com/#discover
199,1/14/20 6:02pm,shop@sahelsounds.com,payout,,,USD,,,,,,,,2.19,transfer,219.4,217.21,t251185454,4U160583M53038041,,,,-219.4,161.32,,,,,,,,,,,,,,,,,,,,,,,,,,,,
200,1/14/20 6:02pm,shop@sahelsounds.com,payout,,,USD,,,,,,,,0.18,transfer,18.48,18.3,t251185457,43P7035709670013B,,,,-18.48,142.84,,,,,,,,,,,,,,,,,,,,,,,,,,,,
201,1/15/20 1:09am,Bandcamp,package,Ilana: The Creator,Mdou Moctar,USD,17.0,1.0,,17.0,,5.0,United States,1.0,credit card,22.0,0.0,1241747792,,1.7,1.7,0.0,19.3,162.14,14.3,Ilana LP,,http://mdoumoctar.bandcamp.com/album/ilana-the-creator,SS-051lp,SS-051,602318 136893,,Megan Smith,travis30@yahoo.com,001-235-496-2439x7142,,Travis Berger,028 Bailey Extension,,SALT LAKE CITY,UT,84102-3807,United States,US,1/21/20,,United States,US,UT,SALT LAKE CITY,Google search,www.google.com/
202,1/15/20 1:35am,Bandcamp,album,Tiris,El Wali,USD,7.0,1.0,,7.0,,,,0.4,paypal,7.0,0.0,82713311,,0.7,0.7,0.0,5.9,168.04,5.9,digital download,,http://elwali.bandcamp.com/album/tiris,,SS-055,602318 136923,,Tonya Mcmahon,ypittman@gmail.com,001-765-207-2227x008,,Jennifer French,09957 Melinda Roads,,,,,,,,,United States,US,OH,Cincinnati,,
203,1/15/20 1:52am,Bandcamp,album,Ilana: The Creator,Mdou Moctar,USD,10.0,1.0,,10.0,,,,0.49,paypal,10.0,0.0,3979516380,,1.0,1.0,0.0,8.51,176.55,8.51,digital download,,http://mdoumoctar.bandcamp.com/album/ilana-the-creator,,SS-051,602318 136893,,Christopher Watkins,clewis@hotmail.com,001-599-869-9279,,John Valdez,9319 Sean Walk,,,,,,,,,United States,US,CA,Lomita,Bandcamp search,bandcamp.com/autocomplete-search
204,1/15/20 2:05am,Bandcamp,album,Sahel Sounds Label Sampler,Various Artists,USD,2.0,1.0,,2.0,,,,0.17,credit card,2.0,0.0,2690138241,,0.2,0.2,0.0,1.63,178.18,1.63,digital download,,http://sahelsounds.bandcamp.com/album/sahel-sounds-label-sampler,,SS-058,602318 137111,,Mary Sandoval,caseynancy@oconnell.com,9277470623,,Tami Branch,622 Jeffrey Corners,,,,,,,,,Canada,CA,BC,Kamloops,,
205,1/15/20 6:35am,Bandcamp,album,Music from Saharan WhatsApp,Etran de L'Aïr,USD,1.0,1.0,,1.0,,,,0.11,paypal,1.0,0.0,2001312212,,0.1,0.1,0.0,0.79,178.97,0.79,digital download,,http://etrandelair.bandcamp.com/album/music-from-saharan-whatsapp,,WHATSAPP-01,,,Elizabeth Hernandez,torresmichelle@lang.org,463.740.5603x2290,,James Martinez,4142 Margaret Manors Apt. 616,,,,,,,,,Netherlands,NL,North Holland,Amsterdam,Publish notice sent to your fans,
206,1/15/20 6:39am,Bandcamp,album,Music from Saharan WhatsApp,Etran de L'Aïr,USD,4.0,1.0,,4.0,,,,0.25,paypal,4.0,0.0,3519012387,,0.4,0.4,0.0,3.35,182.32,3.35,digital download,,http://etrandelair.bandcamp.com/album/music-from-saharan-whatsapp,,WHATSAPP-01,,,Debra Cohen,frivas@yahoo.com,(146)568-0355x587,,Angel Hansen,5831 Tara Lights Suite 147,,,,,,,,,United States,US,CA,Milpitas,Publish notice sent to your fans,
207,1/15/20 6:56am,Bandcamp,album,Music from Saharan WhatsApp,Etran de L'Aïr,USD,2.0,1.0,,2.0,,,,0.15,credit card,2.0,0.0,802950101,,0.2,0.2,0.0,1.65,183.97,1.65,digital download,,http://etrandelair.bandcamp.com/album/music-from-saharan-whatsapp,,WHATSAPP-01,,,Anthony Contreras,pattersonchristopher@hotmail.com,+1-915-546-3182x42799,,Denise Kelly,33879 Ortega Turnpike,,,,,,,,,United States,US,CA,San Francisco,Publish notice sent to your fans,
208,1/15/20 6:57am,Bandcamp,album,Music from Saharan WhatsApp,Etran de L'Aïr,USD,5.0,1.0,,5.0,,,,0.35,paypal,5.0,0.0,865783110,,0.5,0.5,0.0,4.15,188.12,4.15,digital download,,http://etrandelair.bandcamp.com/album/music-from-saharan-whatsapp,,WHATSAPP-01,,,Miranda Evans,sonya32@carr-wilcox.info,+1-015-126-2397,,Amber Haynes,21721 Peter Place,,,,,,,,,Netherlands,NL,Provincie Overijssel,Almelo,Publish notice sent to your fans,
209,1/15/20 7:01am,Bandcamp,album,Music from Saharan WhatsApp,Etran de L'Aïr,USD,1.0,1.0,,1.0,,,,0.11,credit card,1.0,0.0,978369834,,0.1,0.1,0.0,0.79,188.91,0.79,digital download,,http://etrandelair.bandcamp.com/album/music-from-saharan-whatsapp,,WHATSAPP-01,,,Walter Leonard,mmeadows@yahoo.com,+1-244-453-6079x302,,Tracy Frost,173 Salazar Locks,,,,,,,,,United Kingdom,GB,Renfrewshire,Paisley,Publish notice sent to your fans,
210,1/15/20 7:26am,Bandcamp,album,Music from Saharan WhatsApp,Etran de L'Aïr,USD,1.0,1.0,,1.0,,,,0.11,paypal,1.0,0.0,3305866122,,0.1,0.1,0.0,0.79,189.7,0.79,digital download,,http://etrandelair.bandcamp.com/album/music-from-saharan-whatsapp,,WHATSAPP-01,,,Laura Williamson,sarah19@johnson-farley.com,866.272.2800,,Michele Garcia,70884 Christopher Islands,,,,,,,,,Japan,JP,Tokyo,Meguro-ku,Publish notice sent to your fans,
211,1/15/20 7:32am,Bandcamp,album,No. 1,Etran de L'Aïr,USD,7.0,1.0,,7.0,,,,0.49,paypal,7.0,0.0,882688755,,0.7,0.0,0.7,0.0,189.7,5.81,digital download,,http://etrandelair.bandcamp.com/album/no-1,,SS-045,602318 136824,,Sandra Evans,andrewhunter@riley.biz,640-064-6414x0520,,Duane Becker,0475 Charles Ports,,,,,,,,,United States,US,CA,Santa Monica,Publish notice sent to your fans,
212,1/15/20 7:32am,Bandcamp,album,Music from Saharan WhatsApp,Etran de L'Aïr,USD,3.0,1.0,,3.0,,,,,,3.0,0.0,882688755,,0.3,1.0,0.0,8.51,198.21,2.7,digital download,,http://etrandelair.bandcamp.com/album/music-from-saharan-whatsapp,,WHATSAPP-01,,,Anita Nguyen,kimberlywilson@gmail.com,001-233-233-0034,,Michelle Thomas,08081 Scott Ways Suite 057,,,,,,,,,United States,US,CA,Santa Monica,,
213,1/15/20 7:36am,Bandcamp,album,Music from Saharan WhatsApp,Etran de L'Aïr,USD,4.0,1.0,,4.0,,,,0.29,paypal,4.0,0.0,3149768939,,0.4,0.4,0.0,3.31,201.52,3.31,digital download,,http://etrandelair.bandcamp.com/album/music-from-saharan-whatsapp,,WHATSAPP-01,,,Felicia Schneider,kylesmith@james-jenkins.net,220-609-3361x137,,Zachary House,43715 Stephanie Via,,,,,,,,,United Kingdom,GB,,,Publish notice sent to your fans,
214,1/15/20 8:10am,Bandcamp,album,Music from Saharan WhatsApp,Etran de L'Aïr,USD,2.5,1.0,,2.5,,,,0.2,paypal,2.5,0.0,2001143784,,0.25,0.25,0.0,2.05,203.57,2.05,digital download,,http://etrandelair.bandcamp.com/album/music-from-saharan-whatsapp,,WHATSAPP-01,,,Peter Moran,alicia58@hotmail.com,(747)791-9607x996,,Marie Harris,31231 Matthew Pine Apt. 632,,,,,,,,,Netherlands,NL,Provincie Utrecht,Utrecht,Publish notice sent to your fans,
215,1/15/20 8:28am,Bandcamp,album,Music from Saharan WhatsApp,Etran de L'Aïr,USD,3.0,1.0,,3.0,,,,0.23,credit card,3.0,0.0,167018893,,0.3,0.3,0.0,2.47,206.04,2.47,digital download,,http://etrandelair.bandcamp.com/album/music-from-saharan-whatsapp,,WHATSAPP-01,,,Sandra Rhodes,ewolf@bryant.net,636-260-6421x097,,Shannon Keller,66863 Kyle Point Apt. 478,,,,,,,,,Poland,PL,Lesser Poland,Krakow,Publish notice sent to your fans,
216,1/15/20 8:47am,Bandcamp,album,Music from Saharan WhatsApp,Etran de L'Aïr,USD,2.0,1.0,,2.0,,,,0.17,paypal,2.0,0.0,3563250365,,0.2,0.2,0.0,1.63,207.67,1.63,digital download,,http://etrandelair.bandcamp.com/album/music-from-saharan-whatsapp,,WHATSAPP-01,,,Mary Benson,karensmith@ferguson.biz,031-971-2832x4066,,Kristin Silva,0422 Lyons Glens,,,,,,,,,United Kingdom,GB,Redbridge,Ilford,Publish notice sent to your fans,
217,1/15/20 8:51am,Bandcamp,album,Music from Saharan WhatsApp,Etran de L'Aïr,USD,1.0,1.0,,1.0,,,,0.11,paypal,1.0,0.0,3418493220,,0.1,0.1,0.0,0.79,208.46,0.79,digital download,,http://etrandelair.bandcamp.com/album/music-from-saharan-whatsapp,,WHATSAPP-01,,,Jennifer Fernandez,sylvia63@hampton.biz,001-758-334-5143x05500,,Nicole Smith,57968 Scott Avenue,,,,,,,,,Finland,FI,Uusimaa,Helsinki,Publish notice sent to your fans,
218,1/15/20 9:30am,Bandcamp,album,Music from Saharan WhatsApp,Etran de L'Aïr,USD,3.0,1.0,,3.0,,,,0.2,paypal,3.0,0.0,3429419636,,0.3,0.3,0.0,2.5,210.96,2.5,digital download,,http://etrandelair.bandcamp.com/album/music-from-saharan-whatsapp,,WHATSAPP-01,,,Sheila Adkins,patrickmorris@gmail.com,924.778.0747,,April Allen,4149 Hall Lane Suite 567,,,,,,,,,Saudi Arabia,SA,Makkah Province,Thuwal,Bandcamp search,bandcamp.com/autocomplete-search
219,1/15/20 9:37am,Bandcamp,album,Music from Saharan WhatsApp,Etran de L'Aïr,USD,1.0,1.0,,1.0,,,,0.11,paypal,1.0,0.0,72109314,,0.1,0.1,0.0,0.79,211.75,0.79,digital download,,http://etrandelair.bandcamp.com/album/music-from-saharan-whatsapp,,WHATSAPP-01,,,Dustin Carter,owensalan@ward-gross.com,069-319-0676x6184,,Katherine King,072 Warner Drive Suite 867,,,,,,,,,United Kingdom,GB,Rochdale,Rochdale,Publish notice sent to your fans,
220,1/15/20 9:37am,Bandcamp,album,Music from Saharan WhatsApp,Etran de L'Aïr,USD,1.0,1.0,,1.0,,,,0.11,paypal,1.0,0.0,568724775,,0.1,0.1,0.0,0.79,212.54,0.79,digital download,,http://etrandelair.bandcamp.com/album/music-from-saharan-whatsapp,,WHATSAPP-01,,,Maria Lopez,brownamy@hotmail.com,+1-598-416-0953,,Tyler Wood,550 Julie Cliffs,,,,,,,,,United Kingdom,GB,Ceredigion,Cardigan,Publish notice sent to your fans,
221,1/15/20 9:54am,Bandcamp,album,Music from Saharan WhatsApp,Etran de L'Aïr,USD,4.0,1.0,,4.0,,,,0.29,paypal,4.0,0.0,3322326556,,0.4,0.4,0.0,3.31,215.85,3.31,digital download,,http://etrandelair.bandcamp.com/album/music-from-saharan-whatsapp,,WHATSAPP-01,,,Rebecca David,beverlyjones@hotmail.com,827-004-9377x7937,,Catherine Allen,350 Cindy Lodge Suite 871,,,,,,,,,United Kingdom,GB,England,London,Publish notice sent to your fans,
222,1/15/20 9:54am,Bandcamp,album,Music from Saharan WhatsApp,Etran de L'Aïr,USD,1.0,1.0,,1.0,,,,0.11,paypal,1.0,0.0,3235292206,,0.1,0.1,0.0,0.79,216.64,0.79,digital download,,http://etrandelair.bandcamp.com/album/music-from-saharan-whatsapp,,WHATSAPP-01,,,Lisa Stevenson,lee99@cameron-garcia.com,662.514.9398,,Steven Garza,6452 Holloway Roads Apt. 899,,,,,,,,,Portugal,PT,Porto,Porto,Publish notice sent to your fans,
223,1/15/20 9:58am,Bandcamp,album,Music from Saharan WhatsApp,Etran de L'Aïr,USD,3.0,1.0,,3.0,,,,0.2,paypal,3.0,0.0,2894320791,,0.3,0.3,0.0,2.5,219.14,2.5,digital download,,http://etrandelair.bandcamp.com/album/music-from-saharan-whatsapp,,WHATSAPP-01,,,Maureen Cantu,shawjose@castro.net,(114)751-4135x099,,Carrie Johnson,5040 Amber Fall Apt. 925,,,,,,,,,Turkey,TR,Istanbul,Istanbul,Publish notice sent to your fans,
224,1/15/20 10:01am,Bandcamp,album,Music from Saharan WhatsApp,Etran de L'Aïr,USD,1.0,1.0,,1.0,,,,0.11,paypal,1.0,0.0,954747675,,0.1,0.1,0.0,0.79,219.93,0.79,digital download,,http://etrandelair.bandcamp.com/album/music-from-saharan-whatsapp,,WHATSAPP-01,,,David Riley,carolinechavez@gmail.com,480-856-7955,,Mackenzie Griffin,7410 Carter Loop,,,,,,,,,Belgium,BE,Antwerp Province,Edegem,Bandcamp search,bandcamp.com/autocomplete-search
225,1/15/20 10:44am,Bandcamp,album,Music from Saharan WhatsApp,Etran de L'Aïr,USD,1.5,1.0,,1.5,,,,0.14,credit card,1.5,0.0,907235083,,0.15,0.15,0.0,1.21,221.14,1.21,digital download,,http://etrandelair.bandcamp.com/album/music-from-saharan-whatsapp,,WHATSAPP-01,,,Daniel Green,dawn84@hotmail.com,234.617.9377x0129,,Alice Reid,07444 Christopher View,,,,,,,,,United Kingdom,GB,Glasgow City,Glasgow,Publish notice sent to your fans,
226,1/15/20 11:36am,Bandcamp,album,Music from Saharan WhatsApp,Etran de L'Aïr,USD,2.0,1.0,,2.0,,,,0.17,credit card,2.0,0.0,2736149712,,0.2,0.2,0.0,1.63,222.77,1.63,digital download,,http://etrandelair.bandcamp.com/album/music-from-saharan-whatsapp,,WHATSAPP-01,,,Adam Meyer,johnsonnatasha@west.org,713.076.6768,,Linda Davis,220 Bailey Via,,,,,,,,,Brazil,BR,Paraíba,João Pessoa,Publish notice sent to your fans,
227,1/15/20 11:47am,Bandcamp,album,Music from Saharan WhatsApp,Etran de L'Aïr,USD,3.0,1.0,,3.0,,,,0.23,paypal,3.0,0.0,2811880502,,0.3,0.3,0.0,2.47,225.24,2.47,digital download,,http://etrandelair.bandcamp.com/album/music-from-saharan-whatsapp,,WHATSAPP-01,,,Lorraine Hayden,millerkayla@gmail.com,(021)003-1555,,Tracey Torres,15642 Harvey Plaza,,,,,,,,,Spain,ES,Malaga,Málaga,Publish notice sent to your fans,
228,1/15/20 12:02pm,Bandcamp,album,Music from Saharan WhatsApp,Etran de L'Aïr,USD,3.0,1.0,,3.0,,,,0.2,paypal,3.0,0.0,1872635846,,0.3,0.3,0.0,2.5,227.74,2.5,digital download,,http://etrandelair.bandcamp.com/album/music-from-saharan-whatsapp,,WHATSAPP-01,,,Michelle Long,kylieparrish@gmail.com,917.380.8152x65105,,Ashley Sanford,32442 Conner Hill,,,,,,,,,United States,US,NY,Rochester,Publish notice sent to your fans,
229,1/15/20 12:43pm,Bandcamp,album,Music from Saharan WhatsApp,Etran de L'Aïr,USD,6.0,1.0,,6.0,,,,0.35,credit card,6.0,0.0,3807082022,,0.6,0.6,0.0,5.05,232.79,5.05,digital download,,http://etrandelair.bandcamp.com/album/music-from-saharan-whatsapp,,WHATSAPP-01,,,Sheryl Best,christopher08@gmail.com,7578803654,,Michael Diaz,1980 Pruitt Well,,,,,,,,,United States,US,IA,Des Moines,Publish notice sent to your fans,
230,1/15/20 12:52pm,Bandcamp,album,Music from Saharan WhatsApp,Etran de L'Aïr,USD,6.0,1.0,,6.0,,,,0.35,paypal,6.0,0.0,116447231,,0.6,0.6,0.0,5.05,237.84,5.05,digital download,,http://etrandelair.bandcamp.com/album/music-from-saharan-whatsapp,,WHATSAPP-01,,,Heather Wyatt,nparks@gmail.com,001-241-313-0565,,Lisa Hoffman,3850 James Ford Apt. 556,,,,,,,,,United States,US,GA,Atlanta,Publish notice sent to your fans,
231,1/15/20 12:53pm,Bandcamp,album,Music from Saharan WhatsApp,Etran de L'Aïr,USD,4.0,1.0,,4.0,,,,0.29,paypal,4.0,0.0,1995615105,,0.4,0.4,0.0,3.31,241.15,3.31,digital download,,http://etrandelair.bandcamp.com/album/music-from-saharan-whatsapp,,WHATSAPP-01,,,Robert Marshall,katherine36@roberts.com,(617)593-1068x62218,,Meredith Ramirez,428 Jennifer Fork Suite 145,,,,,,,,,United Kingdom,GB,Trafford,Sale,Publish notice sent to your fans,
232,1/15/20 12:56pm,Bandcamp,album,Music from Saharan WhatsApp,Etran de L'Aïr,USD,3.0,1.0,,3.0,,,,0.2,paypal,3.0,0.0,3673176866,,0.3,0.3,0.0,2.5,243.65,2.5,digital download,,http://etrandelair.bandcamp.com/album/music-from-saharan-whatsapp,,WHATSAPP-01,,,Chad Perez,snguyen@hotmail.com,001-651-164-3505,,Michael Cochran,18598 Johnson Manor Suite 956,,,,,,,,,United States,US,OH,Lakewood,Publish notice sent to your fans,
233,1/15/20 1:01pm,Bandcamp,album,Music from Saharan WhatsApp,Etran de L'Aïr,USD,5.0,1.0,,5.0,,,,0.3,credit card,5.0,0.0,1767652093,,0.5,0.5,0.0,4.2,247.85,4.2,digital download,,http://etrandelair.bandcamp.com/album/music-from-saharan-whatsapp,,WHATSAPP-01,,,Susan Roth,ykrueger@allen.com,846.849.6504,,Allison Flores,88309 Hahn Estate Apt. 155,,,,,,,,,United States,US,IL,Chicago,Publish notice sent to your fans,
234,1/15/20 1:10pm,Bandcamp,album,Music from Saharan WhatsApp,Etran de L'Aïr,USD,1.0,1.0,,1.0,,,,0.1,paypal,1.0,0.0,2598409239,,0.1,0.1,0.0,0.8,248.65,0.8,digital download,,http://etrandelair.bandcamp.com/album/music-from-saharan-whatsapp,,WHATSAPP-01,,,John Conley,tcollins@velasquez.com,934.753.9683,,Jason Anderson,28189 Brenda Squares Apt. 966,,,,,,,,,United States,US,IL,Chicago,Publish notice sent to your fans,
235,1/15/20 1:28pm,Bandcamp,album,Music from Saharan WhatsApp,Etran de L'Aïr,USD,3.0,1.0,,3.0,,,,0.2,paypal,3.0,0.0,3830481284,,0.3,0.3,0.0,2.5,251.15,2.5,digital download,,http://etrandelair.bandcamp.com/album/music-from-saharan-whatsapp,,WHATSAPP-01,,,Joseph Osborn,andrewsimpson@medina-may.biz,061-271-7155x809,,Lisa Terry,1797 Kelli Mission,,,,,,,,,United States,US,MO,St Louis,Publish notice sent to your fans,
236,1/15/20 1:43pm,Bandcamp,album,Music from Saharan WhatsApp,Etran de L'Aïr,USD,10.0,1.0,,10.0,,,,0.49,paypal,10.0,0.0,1885188699,,1.0,1.0,0.0,8.51,259.66,8.51,digital download,,http://etrandelair.bandcamp.com/album/music-from-saharan-whatsapp,,WHATSAPP-01,,,Susan Freeman,william29@anderson-anderson.com,001-949-651-2446x90031,,Shannon Torres,067 Eric Radial Suite 289,,,,,,,,,United States,US,NJ,Montclair,Publish notice sent to your fans,
237,1/15/20 1:45pm,Bandcamp,album,Music from Saharan WhatsApp,Etran de L'Aïr,USD,1.0,1.0,,1.0,,,,0.1,paypal,1.0,0.0,2089430216,,0.1,0.1,0.0,0.8,260.46,0.8,digital download,,http://etrandelair.bandcamp.com/album/music-from-saharan-whatsapp,,WHATSAPP-01,,,Mary Morgan,mlewis@pollard.net,001-509-321-6598x328,,Jessica Brown,6826 Lewis Field,,,,,,,,,United States,US,NY,New York,Publish notice sent to your fans,
238,1/15/20 1:47pm,Bandcamp,album,Music from Saharan WhatsApp,Etran de L'Aïr,USD,2.0,1.0,,2.0,,,,0.17,paypal,2.0,0.0,4043882216,,0.2,0.2,0.0,1.63,262.09,1.63,digital download,,http://etrandelair.bandcamp.com/album/music-from-saharan-whatsapp,,WHATSAPP-01,,,John Mitchell,stacey53@henderson.com,001-047-195-4676x23100,,Benjamin Rowe,0493 Jordan Port Suite 243,,,,,,,,,Netherlands,NL,South Holland,Zuidland,Publish notice sent to your fans,
239,1/15/20 2:15pm,Bandcamp,album,Music from Saharan WhatsApp,Etran de L'Aïr,USD,5.0,1.0,,5.0,,,,0.35,credit card,5.0,0.0,1281336173,,0.5,0.5,0.0,4.15,266.24,4.15,digital download,,http://etrandelair.bandcamp.com/album/music-from-saharan-whatsapp,,WHATSAPP-01,,,Lisa Hall,dturner@yahoo.com,001-823-609-1616x5189,,Stephanie Smith,26031 James Drives Apt. 372,,,,,,,,,Italy,IT,Rome,Rome,,
240,1/15/20 2:16pm,Bandcamp,album,Music from Saharan WhatsApp,Etran de L'Aïr,USD,1.0,1.0,,1.0,,,,0.11,credit card,1.0,0.0,1841981827,,0.1,0.1,0.0,0.79,267.03,0.79,digital download,,http://etrandelair.bandcamp.com/album/music-from-saharan-whatsapp,,WHATSAPP-01,,,Carol Williams,manuelduncan@yahoo.com,001-822-724-0087x555,,Angela Bell,6922 Mcdaniel Ferry Suite 007,,,,,,,,,Canada,CA,ON,Ottawa,Publish notice sent to your fans,
241,1/15/20 2:43pm,Bandcamp,album,Music from Saharan WhatsApp,Etran de L'Aïr,USD,8.0,1.0,,8.0,,,,0.45,credit card,8.0,0.0,3198851042,,0.8,0.8,0.0,6.75,273.78,6.75,digital download,,http://etrandelair.bandcamp.com/album/music-from-saharan-whatsapp,,WHATSAPP-01,,,Tyler Davenport,cbyrd@gmail.com,+1-554-838-4658,,David Camacho,03400 Garcia Views Suite 742,,,,,,,,,United States,US,NY,New York,Publish notice sent to your fans,
242,1/15/20 2:54pm,Bandcamp,album,Music from Saharan WhatsApp,Etran de L'Aïr,USD,2.0,1.0,,2.0,,,,0.15,paypal,2.0,0.0,2265274454,,0.2,0.2,0.0,1.65,275.43,1.65,digital download,,http://etrandelair.bandcamp.com/album/music-from-saharan-whatsapp,,WHATSAPP-01,,,Joseph Fuentes,stephaniereed@olson.com,9973557717,,Harold Ramos,6749 Ann Junctions Apt. 471,,,,,,,,,United States,US,TX,Dallas,Publish notice sent to your fans,
243,1/15/20 3:13pm,Bandcamp,album,Music from Saharan WhatsApp,Etran de L'Aïr,USD,1.0,1.0,,1.0,,,,0.11,paypal,1.0,0.0,3430090580,,0.1,0.1,0.0,0.79,276.22,0.79,digital download,,http://etrandelair.bandcamp.com/album/music-from-saharan-whatsapp,,WHATSAPP-01,,,Michele Martinez,wilsondarrell@moreno.com,(613)345-1441,,Timothy Nelson,40276 Moran Club Apt. 302,,,,,,,,,Ireland,IE,Leinster,Dublin,Publish notice sent to your fans,
244,1/15/20 4:15pm,Bandcamp,album,Music from Saharan WhatsApp,Etran de L'Aïr,USD,1.0,1.0,,1.0,,,,0.1,paypal,1.0,0.0,3140815577,,0.1,0.1,0.0,0.8,277.02,0.8,digital download,,http://etrandelair.bandcamp.com/album/music-from-saharan-whatsapp,,WHATSAPP-01,,,Michelle Peterson,amandacolon@yahoo.com,426-845-8921x98972,,John Nguyen,459 Kelsey Causeway Suite 388,,,,,,,,,United States,US,NJ,Secaucus,Publish notice sent to your fans,
245,1/15/20 4:16pm,Bandcamp,album,Music from Saharan WhatsApp,Etran de L'Aïr,USD,5.0,1.0,,5.0,,,,0.3,credit card,5.0,0.0,2175775033,,0.5,0.5,0.0,4.2,281.22,4.2,digital download,,http://etrandelair.bandcamp.com/album/music-from-saharan-whatsapp,,WHATSAPP-01,,,Shelby Lane,gary93@mcclain.com,+1-429-195-4926x038,,Brandon Moore,08351 Atkinson Village Apt. 784,,,,,,,,,United States,US,NY,New York,Publish notice sent to your fans,
246,1/15/20 4:26pm,Bandcamp,track,Anou Malane,Abdallah Ag Oumbadougou,USD,1.0,1.0,,1.0,,,,0.1,credit card,1.0,0.0,3992865020,,0.1,0.1,0.0,0.8,282.02,0.8,digital download,,http://abdallahagoumbadougou.bandcamp.com/track/anou-malane,,SS-053,,,Julie Hanson,wolfjoshua@yahoo.com,2253960816,,Brandon Brown,513 Robert Ville Apt. 943,,,,,,,,,United States,US,VA,Charlottesville,Bandcamp Daily: best-reissues-on-bandcamp-august-september-2019,daily.bandcamp.com/best-reissues/best-reissues-on-bandcamp-august-september-2019
247,1/15/20 4:30pm,Bandcamp,album,Music from Saharan WhatsApp,Etran de L'Aïr,USD,5.0,1.0,,5.0,,,,0.35,paypal,5.0,0.0,2963049445,,0.5,0.5,0.0,4.15,286.17,4.15,digital download,,http://etrandelair.bandcamp.com/album/music-from-saharan-whatsapp,,WHATSAPP-01,,,Christopher Wilson,uthomas@perez.org,448.725.0654x09653,,Darryl Butler,185 Lewis Prairie Apt. 684,,,,,,,,,Germany,DE,,,Bandcamp music feed,http://blog.bandcamp.com/2014/01/30/bandcamp-app-now-with-music-feed/
248,1/15/20 4:34pm,Bandcamp,album,Music from Saharan WhatsApp,Etran de L'Aïr,USD,4.0,1.0,,4.0,,,,0.25,paypal,4.0,0.0,3103142064,,0.4,0.4,0.0,3.35,289.52,3.35,digital download,,http://etrandelair.bandcamp.com/album/music-from-saharan-whatsapp,,WHATSAPP-01,,,Michael Rice,donna25@alvarez.com,918-826-2257x0762,,David Campbell,21960 Brown Run Apt. 202,,,,,,,,,United States,US,CT,Willimantic,Publish notice sent to your fans,
249,1/15/20 4:54pm,Bandcamp,album,Ilana: The Creator,Mdou Moctar,USD,7.0,1.0,,7.0,,,,0.4,paypal,7.0,0.0,3684179893,,0.7,0.7,0.0,5.9,295.42,5.9,digital download,,http://mdoumoctar.bandcamp.com/album/ilana-the-creator,,SS-051,602318 136893,,Heather Clark,crawfordmichelle@hotmail.com,001-039-950-4590x9148,,Alexander Richardson,3885 Jeremy Villages,,,,,,,,,United States,US,FL,Jacksonville,,
250,1/15/20 4:58pm,Bandcamp,album,Music from Saharan WhatsApp,Etran de L'Aïr,USD,5.0,1.0,,5.0,,,,0.3,paypal,5.0,0.0,2860610378,,0.5,0.5,0.0,4.2,299.62,4.2,digital download,,http://etrandelair.bandcamp.com/album/music-from-saharan-whatsapp,,WHATSAPP-01,,,Daniel Kelly,robert13@gmail.com,969-027-2211x0150,,Teresa Bryant,644 James Lights Suite 296,,,,,,,,,United States,US,CA,Oakland,,
251,1/15/20 5:11pm,Bandcamp,album,Music from Saharan WhatsApp,Etran de L'Aïr,USD,10.0,1.0,,10.0,,,,0.52,credit card,10.0,0.0,890641298,,1.0,1.0,0.0,8.48,308.1,8.48,digital download,,http://etrandelair.bandcamp.com/album/music-from-saharan-whatsapp,,WHATSAPP-01,,,Angela Rose,gregoryjohnson@gmail.com,001-385-959-2773x353,,Donald Ferguson,776 Russell Islands,,,,,,,,,United States,US,PA,Philadelphia,Publish notice sent to your fans,
252,1/15/20 5:20pm,Bandcamp,album,Music from Saharan WhatsApp,Etran de L'Aïr,USD,8.0,1.0,,8.0,,,,0.45,credit card,8.0,0.0,2553711558,,0.8,0.8,0.0,6.75,314.85,6.75,digital download,,http://etrandelair.bandcamp.com/album/music-from-saharan-whatsapp,,WHATSAPP-01,,,Thomas Hunter,mrios@bridges.com,143-834-7477x2699,,Gwendolyn Fox,8337 Robinson Parkway,,,,,,,,,United States,US,OR,Portland,Bandcamp search: “etran de l'air”,bandcamp.com/search?q=etran%20de%20l%27air
253,1/15/20 5:23pm,Bandcamp,album,Music from Saharan WhatsApp,Etran de L'Aïr,USD,4.0,1.0,,4.0,,,,0.29,paypal,4.0,0.0,1742786514,,0.4,0.4,0.0,3.31,318.16,3.31,digital download,,http://etrandelair.bandcamp.com/album/music-from-saharan-whatsapp,,WHATSAPP-01,,,Michael Rivera,matthewgonzalez@reynolds.biz,(779)830-4661x386,,Joshua Winters,6288 Scott Hollow,,,,,,,,,Canada,CA,ON,Toronto,Bandcamp search,bandcamp.com/app/android/search
254,1/15/20 5:23pm,Bandcamp,album,Music from Saharan WhatsApp,Etran de L'Aïr,USD,2.0,1.0,,2.0,,,,0.17,credit card,2.0,0.0,3872216238,,0.2,0.2,0.0,1.63,319.79,1.63,digital download,,http://etrandelair.bandcamp.com/album/music-from-saharan-whatsapp,,WHATSAPP-01,,,Zachary Walsh,aaronduke@yahoo.com,997.779.0675x781,,Kimberly Reed,458 Salinas Alley Apt. 130,,,,,,,,,Poland,PL,Silesia,Mysłowice,Twitter,t.co/1YMVMYCIbh?amp=1
255,1/15/20 5:25pm,Bandcamp,album,Music from Saharan WhatsApp,Etran de L'Aïr,USD,2.0,1.0,,2.0,,,,0.17,credit card,2.0,0.0,2020723609,,0.2,0.2,0.0,1.63,321.42,1.63,digital download,,http://etrandelair.bandcamp.com/album/music-from-saharan-whatsapp,,WHATSAPP-01,,,James Carr,ashley87@ramsey.com,(243)795-1273x303,,Peter Ramirez,8415 Diana Green,,,,,,,,,United Kingdom,GB,Devon,Exeter,Publish notice sent to your fans,
256,1/15/20 5:30pm,Bandcamp,album,Music from Saharan WhatsApp,Etran de L'Aïr,USD,10.0,1.0,,10.0,,,,0.52,credit card,10.0,0.0,2275596613,,1.0,1.0,0.0,8.48,329.9,8.48,digital download,,http://etrandelair.bandcamp.com/album/music-from-saharan-whatsapp,,WHATSAPP-01,,,Andrew Garcia,danielburns@gmail.com,0266677903,This is so good!,Gregory Miller,61205 Carpenter Drives,,,,,,,,,United States,US,MN,Saint Paul,Bandcamp fan wishlist,bandcamp.com/craigruhland
257,1/15/20 5:30pm,Bandcamp,album,Music from Saharan WhatsApp,Etran de L'Aïr,USD,1.0,1.0,,1.0,,,,0.1,paypal,1.0,0.0,2752740267,,0.1,0.1,0.0,0.8,330.7,0.8,digital download,,http://etrandelair.bandcamp.com/album/music-from-saharan-whatsapp,,WHATSAPP-01,,,Todd Cooper,tmitchell@byrd.com,468.199.2614,,Tiffany Simmons,86755 Mason Coves Suite 571,,,,,,,,,United States,US,WI,Madison,Facebook,www.facebook.com
258,1/15/20 5:30pm,Bandcamp,album,Music from Saharan WhatsApp,Etran de L'Aïr,USD,1.0,1.0,,1.0,,,,0.1,paypal,1.0,0.0,394621835,,0.1,0.1,0.0,0.8,331.5,0.8,digital download,,http://etrandelair.bandcamp.com/album/music-from-saharan-whatsapp,,WHATSAPP-01,,,Sheila Greene,zmann@wu.com,+1-910-010-1477x722,,Brandon Pham,878 Taylor Brook,,,,,,,,,United States,US,OR,Portland,Google search,www.google.com/
259,1/15/20 5:30pm,Bandcamp,album,Tenere,Afous d'Afous,USD,7.0,1.0,,7.0,1.4,,,0.57,credit card,8.4,0.0,2502797519,,0.7,0.7,0.0,5.73,337.23,5.73,digital download,,http://afousdafous.bandcamp.com/album/tenere,,SS-042,191515 490421,,Peter Jimenez,nicholspatrick@gmail.com,876-377-0648,,Ian Nguyen,271 Phillips Shores,,,,,,,,,United Kingdom,GB,Devon,Exeter,,
260,1/15/20 5:31pm,Bandcamp,album,Music from Saharan WhatsApp,Etran de L'Aïr,USD,5.0,1.0,,5.0,,,,0.3,credit card,5.0,0.0,3704841684,,0.5,0.5,0.0,4.2,341.43,4.2,digital download,,http://etrandelair.bandcamp.com/album/music-from-saharan-whatsapp,,WHATSAPP-01,,,Alyssa Espinoza,timothydonovan@wilson.com,(978)101-0143x000,,Michelle Bond,267 Colon Vista Apt. 146,,,,,,,,,United States,US,OH,Columbus,,
261,1/15/20 5:32pm,Bandcamp,album,Music from Saharan WhatsApp,Etran de L'Aïr,USD,3.0,1.0,,3.0,,,,0.2,credit card,3.0,0.0,1073827751,,0.3,0.3,0.0,2.5,343.93,2.5,digital download,,http://etrandelair.bandcamp.com/album/music-from-saharan-whatsapp,,WHATSAPP-01,,,Melissa Guerra,obennett@butler.org,993-519-5910x75643,,Anthony Anderson,2046 Jimenez Square,,,,,,,,,United States,US,NY,Brooklyn,,
262,1/15/20 5:32pm,Bandcamp,album,Sahel Sounds Label Sampler,Various Artists,USD,1.0,1.0,,1.0,,,,0.1,paypal,1.0,0.0,45830265,,0.1,0.1,0.0,0.8,344.73,0.8,digital download,,http://sahelsounds.bandcamp.com/album/sahel-sounds-label-sampler,,SS-058,602318 137111,,Eric Collins,owensjames@hotmail.com,(178)535-5469x6819,,Kenneth Gordon,679 Hale Union,,,,,,,,,United States,US,NY,Astoria,Twitter,t.co/d6EMnvx1XL?amp=1
263,1/15/20 5:35pm,Bandcamp,album,Music from Saharan WhatsApp,Etran de L'Aïr,USD,6.0,1.0,,6.0,,,,0.35,paypal,6.0,0.0,40066292,,0.6,0.6,0.0,5.05,349.78,5.05,digital download,,http://etrandelair.bandcamp.com/album/music-from-saharan-whatsapp,,WHATSAPP-01,,,Brian Nguyen,taylorkimberly@raymond.info,379-365-3917,,Austin Gordon,611 David Island Apt. 671,,,,,,,,,United States,US,WA,Seattle,Bandcamp search,bandcamp.com/autocomplete-search
264,1/15/20 5:35pm,Bandcamp,album,Music from Saharan WhatsApp,Etran de L'Aïr,USD,3.0,1.0,,3.0,,,,0.23,paypal,3.0,0.0,3510520435,,0.3,0.3,0.0,2.47,352.25,2.47,digital download,,http://etrandelair.bandcamp.com/album/music-from-saharan-whatsapp,,WHATSAPP-01,,,Lauren Edwards,coxjorge@smith-miller.org,772.275.8272x06928,,Catherine Dean,374 Jennifer Lake Suite 929,,,,,,,,,Canada,CA,BC,Vancouver,,
265,1/15/20 5:37pm,Bandcamp,album,Music from Saharan WhatsApp,Etran de L'Aïr,USD,2.0,1.0,,2.0,,,,0.17,paypal,2.0,0.0,710900,,0.2,0.2,0.0,1.63,353.88,1.63,digital download,,http://etrandelair.bandcamp.com/album/music-from-saharan-whatsapp,,WHATSAPP-01,,,Shawn Singh,josephpierce@gmail.com,635.717.3510,,Nancy Anderson,97637 Vicki Divide,,,,,,,,,United Kingdom,GB,Bromley,Bromley,,
266,1/15/20 5:39pm,Bandcamp,album,Music from Saharan WhatsApp,Etran de L'Aïr,USD,3.0,1.0,,3.0,,,,0.2,paypal,3.0,0.0,392618175,,0.3,0.3,0.0,2.5,356.38,2.5,digital download,,http://etrandelair.bandcamp.com/album/music-from-saharan-whatsapp,,WHATSAPP-01,,,James Gilbert,barnettmorgan@harris.biz,+1-350-700-6479x773,,Dennis Randall,78221 Duke Skyway Suite 666,,,,,,,,,United States,US,DC,Washington,Facebook,www.facebook.com
267,1/15/20 5:49pm,Bandcamp,album,Music from Saharan WhatsApp,Etran de L'Aïr,USD,8.0,1.0,,8.0,,,,0.53,paypal,8.0,0.0,3221976073,,0.8,0.8,0.0,6.67,363.05,6.67,digital download,,http://etrandelair.bandcamp.com/album/music-from-saharan-whatsapp,,WHATSAPP-01,,,Brian Reeves,mariewilliams@baker.org,6493155558,,Eddie Scott,21654 Nancy Hollow Suite 370,,,,,,,,,Ireland,IE,Leinster,Dublin,,
268,1/15/20 5:51pm,Bandcamp,album,Music from Saharan WhatsApp,Etran de L'Aïr,USD,10.0,1.0,,10.0,,,,0.59,paypal,10.0,0.0,2701668002,,1.0,1.0,0.0,8.41,371.46,8.41,digital download,,http://etrandelair.bandcamp.com/album/music-from-saharan-whatsapp,,WHATSAPP-01,,,Katie Pruitt,jenniferwilliams@mueller.com,468.603.4925,,Dustin Harrell,56073 Fox Circle Suite 143,,,,,,,,,Poland,PL,Pomerania,Gdynia,,
269,1/15/20 5:53pm,Bandcamp,album,Music from Saharan WhatsApp,Etran de L'Aïr,USD,10.0,1.0,,10.0,,,,0.49,paypal,10.0,0.0,1024901125,,1.0,1.0,0.0,8.51,379.97,8.51,digital download,,http://etrandelair.bandcamp.com/album/music-from-saharan-whatsapp,,WHATSAPP-01,,,Kelli Kirby,fitzgeraldalicia@hotmail.com,(186)030-4285,,Kevin Palmer,82444 Tina Loaf,,,,,,,,,United States,US,CA,Mission Viejo,Publish notice sent to your fans,
270,1/15/20 5:56pm,Bandcamp,album,Music from Saharan WhatsApp,Etran de L'Aïr,USD,3.0,1.0,,3.0,,,,0.2,credit card,3.0,0.0,99103427,,0.3,0.3,0.0,2.5,382.47,2.5,digital download,,http://etrandelair.bandcamp.com/album/music-from-saharan-whatsapp,,WHATSAPP-01,,,Maria Hayden,pgutierrez@hotmail.com,(783)871-9684x6434,,Emily Chang,39571 Wendy Summit,,,,,,,,,United States,US,TX,Dallas,,
271,1/15/20 5:56pm,Bandcamp,album,Music from Saharan WhatsApp,Etran de L'Aïr,USD,5.0,1.0,,5.0,,,,0.3,paypal,5.0,0.0,1017859465,,0.5,0.5,0.0,4.2,386.67,4.2,digital download,,http://etrandelair.bandcamp.com/album/music-from-saharan-whatsapp,,WHATSAPP-01,,,William Atkins,wilsonnicole@smith-gonzalez.com,001-856-962-8391x3136,,James Cantu,22278 Jimenez Square Suite 614,,,,,,,,,United States,US,TN,Brentwood,Google search,www.google.com/
272,1/15/20 5:59pm,Bandcamp,album,Sahel Sounds Label Sampler,Various Artists,USD,1.0,1.0,,1.0,,,,0.11,credit card,1.0,0.0,509333082,,0.1,0.1,0.0,0.79,387.46,0.79,digital download,,http://sahelsounds.bandcamp.com/album/sahel-sounds-label-sampler,,SS-058,602318 137111,,Lauren Green,pholmes@yahoo.com,102.890.6612,,Jerry Watkins,89385 Nguyen Run,,,,,,,,,Poland,PL,Silesia,Mysłowice,Twitter,t.co/d6EMnvx1XL?amp=1
273,1/15/20 6:02pm,shop@sahelsounds.com,payout,,,USD,,,,,,,,1.31,transfer,131.11,129.8,t251441467,81176300ES8043226,,,,-131.11,256.35,,,,,,,,,,,,,,,,,,,,,,,,,,,,
274,1/15/20 6:02pm,shop@sahelsounds.com,payout,,,USD,,,,,,,,0.12,transfer,11.73,11.61,t251441464,80R32594DN142772H,,,,-11.73,244.62,,,,,,,,,,,,,,,,,,,,,,,,,,,,
275,1/15/20 6:05pm,Bandcamp,album,Music from Saharan WhatsApp,Etran de L'Aïr,USD,8.0,1.0,,8.0,,,,0.45,paypal,8.0,0.0,3261064388,,0.8,0.8,0.0,6.75,251.37,6.75,digital download,,http://etrandelair.bandcamp.com/album/music-from-saharan-whatsapp,,WHATSAPP-01,,,Joel Swanson,staffordcaitlin@yahoo.com,007.284.3282,,John Wallace,413 Moore Circles Suite 756,,,,,,,,,United States,US,,,Publish notice sent to your fans,
276,1/15/20 6:10pm,Bandcamp,album,Music from Saharan WhatsApp,Etran de L'Aïr,USD,5.0,1.0,,5.0,,,,0.35,paypal,5.0,0.0,2911485467,,0.5,0.5,0.0,4.15,255.52,4.15,digital download,,http://etrandelair.bandcamp.com/album/music-from-saharan-whatsapp,,WHATSAPP-01,,,Andrew Clark,vbeck@yahoo.com,472.849.6266x043,,Frederick Miller,41547 Carlos Terrace Apt. 162,,,,,,,,,United Kingdom,GB,Manchester,Manchester,,
277,1/15/20 6:12pm,Bandcamp,album,Ilana: The Creator,Mdou Moctar,USD,8.0,1.0,,8.0,,,,0.45,paypal,8.0,0.0,2365781893,,0.8,0.8,0.0,6.75,262.27,6.75,digital download,,http://mdoumoctar.bandcamp.com/album/ilana-the-creator,,SS-051,602318 136893,,Amy Walker,barbara07@hotmail.com,136.920.1389x347,,Kara Brown,084 Patterson Islands,,,,,,,,,United States,US,,,,
278,1/15/20 6:15pm,Bandcamp,album,Music from Saharan WhatsApp,Etran de L'Aïr,USD,1.0,1.0,,1.0,,,,0.11,paypal,1.0,0.0,1428037103,,0.1,0.1,0.0,0.79,263.06,0.79,digital download,,http://etrandelair.bandcamp.com/album/music-from-saharan-whatsapp,,WHATSAPP-01,,,Nathan Sanford,taylorcarolyn@yahoo.com,093.475.4838x28095,,Annette Harris,1646 Jessica Spur,,,,,,,,,United Kingdom,GB,Haringey,Wood Green,,
279,1/15/20 6:16pm,Bandcamp,album,Music from Saharan WhatsApp,Etran de L'Aïr,USD,3.0,1.0,,3.0,,,,0.23,credit card,3.0,0.0,4241601054,,0.3,0.3,0.0,2.47,265.53,2.47,digital download,,http://etrandelair.bandcamp.com/album/music-from-saharan-whatsapp,,WHATSAPP-01,,,Christine Reese,richard25@yahoo.com,+1-735-358-2017x996,,Billy Atkins,38022 Wendy Throughway,,,,,,,,,United Kingdom,GB,Gloucestershire,Cheltenham,Bandcamp music feed: Chimplesticks - jedwardkeyes,http://blog.bandcamp.com/2013/09/19/strap-on-your-feed-bag/
280,1/15/20 6:17pm,Bandcamp,album,Music from Saharan WhatsApp,Etran de L'Aïr,USD,3.0,1.0,,3.0,,,,0.2,paypal,3.0,0.0,3549060582,,0.3,0.3,0.0,2.5,268.03,2.5,digital download,,http://etrandelair.bandcamp.com/album/music-from-saharan-whatsapp,,WHATSAPP-01,,,Edward Cole,vharris@pham.com,(319)975-3731x838,,Sabrina Williams,924 Miller Ports,,,,,,,,,United States,US,MO,Columbia,,
281,1/15/20 6:20pm,Bandcamp,album,Music from Saharan WhatsApp,Etran de L'Aïr,USD,3.0,1.0,,3.0,,,,0.11,credit card,3.0,0.0,4222968652,,0.3,0.3,0.0,2.59,270.62,2.59,digital download,,http://etrandelair.bandcamp.com/album/music-from-saharan-whatsapp,,WHATSAPP-01,,,Darrell Taylor,william64@hawkins.org,(411)129-4192x429,,Jennifer Romero,235 Garrison Plaza Apt. 490,,,,,,,,,United States,US,CA,Los Angeles,Bandcamp search,bandcamp.com/autocomplete-search
282,1/15/20 6:23pm,Bandcamp,album,Music from Saharan WhatsApp,Etran de L'Aïr,USD,5.0,1.0,,5.0,,,,0.3,credit card,5.0,0.0,4082042751,,0.5,0.5,0.0,4.2,274.82,4.2,digital download,,http://etrandelair.bandcamp.com/album/music-from-saharan-whatsapp,,WHATSAPP-01,,,Justin Greene,dgolden@aguilar-alvarado.org,+1-832-960-8045,,Travis Osborne,897 Klein Green Apt. 820,,,,,,,,,United States,US,CA,Marina del Rey,,
283,1/15/20 6:25pm,Bandcamp,album,Music from Saharan WhatsApp,Etran de L'Aïr,USD,3.0,1.0,,3.0,,,,0.2,credit card,3.0,0.0,2369112796,,0.3,0.3,0.0,2.5,277.32,2.5,digital download,,http://etrandelair.bandcamp.com/album/music-from-saharan-whatsapp,,WHATSAPP-01,,,Kelsey Garner,bblankenship@wood.org,455-988-5258,,Kaitlyn Gutierrez,494 Thomas Corner,,,,,,,,,United States,US,CA,Goleta,,
284,1/15/20 6:30pm,Bandcamp,album,Music from Saharan WhatsApp,Etran de L'Aïr,USD,1.0,1.0,,1.0,,,,0.11,paypal,1.0,0.0,3288525994,,0.1,0.1,0.0,0.79,278.11,0.79,digital download,,http://etrandelair.bandcamp.com/album/music-from-saharan-whatsapp,,WHATSAPP-01,,,Ryan Johnson,davispatrick@wolfe.com,(168)400-8050x7263,,Kimberly Macdonald,0406 Rhodes Spring,,,,,,,,,Canada,CA,BC,Vancouver,Publish notice sent to your fans,
285,1/15/20 6:31pm,Bandcamp,album,Music from Saharan WhatsApp,Etran de L'Aïr,USD,5.0,1.0,,5.0,,,,0.3,paypal,5.0,0.0,427812883,,0.5,0.5,0.0,4.2,282.31,4.2,digital download,,http://etrandelair.bandcamp.com/album/music-from-saharan-whatsapp,,WHATSAPP-01,,,Tammy Young,austin01@stone.net,(618)570-6037x5426,,Jo Ramsey,739 Sharon Mountains,,,,,,,,,United States,US,AL,Tuscaloosa,,
286,1/15/20 6:37pm,Bandcamp,album,Music from Saharan WhatsApp,Etran de L'Aïr,USD,5.0,1.0,,5.0,,,,0.3,paypal,5.0,0.0,495021994,,0.5,0.5,0.0,4.2,286.51,4.2,digital download,,http://etrandelair.bandcamp.com/album/music-from-saharan-whatsapp,,WHATSAPP-01,,,Michelle Salinas,bergerlisa@lowe.net,+1-008-717-3934x5833,,Jeremy Hill,1916 Mary Viaduct,,,,,,,,,United States,US,NY,Brooklyn,Facebook,www.facebook.com
287,1/15/20 6:42pm,Bandcamp,album,Music from Saharan WhatsApp,Etran de L'Aïr,USD,1.0,1.0,,1.0,,,,0.11,paypal,1.0,0.0,2872047039,,0.1,0.1,0.0,0.79,287.3,0.79,digital download,,http://etrandelair.bandcamp.com/album/music-from-saharan-whatsapp,,WHATSAPP-01,,,Gabrielle Salas,matthewhiggins@gomez.com,438.065.9386,,Vicki Olson,824 John Roads Suite 804,,,,,,,,,France,FR,Maine-et-Loire,Angers,,
288,1/15/20 6:43pm,Bandcamp,album,Music from Saharan WhatsApp,Etran de L'Aïr,USD,1.0,1.0,,1.0,,,,0.11,paypal,1.0,0.0,1008422280,,0.1,0.1,0.0,0.79,288.09,0.79,digital download,,http://etrandelair.bandcamp.com/album/music-from-saharan-whatsapp,,WHATSAPP-01,,,Caitlyn Smith,silvajoshua@gmail.com,122-145-2300x52390,,Katherine Yang,53897 Theresa Station Suite 902,,,,,,,,,United Kingdom,GB,,,,
289,1/15/20 6:47pm,Bandcamp,package,No. 1,Etran de L'Aïr,USD,17.0,1.0,,17.0,,5.0,United States,0.72,paypal,22.0,0.0,3549675138,,1.7,1.7,0.0,19.58,307.67,14.58,Limited Edition LP,,http://etrandelair.bandcamp.com/album/no-1,SS-045lp,SS-045,602318 136824,,Melanie Fuller,thomasellis@gmail.com,+1-648-781-4765,,Jennifer Mata,0458 Riley Hill Apt. 851,,Lakewood,OH,44107,United States,US,1/21/20,,United States,US,OH,Lakewood,,
290,1/15/20 6:48pm,Bandcamp,album,Music from Saharan WhatsApp,Etran de L'Aïr,USD,10.0,1.0,,10.0,,,,0.49,paypal,10.0,0.0,2756555998,,1.0,1.0,0.0,8.51,316.18,8.51,digital download,,http://etrandelair.bandcamp.com/album/music-from-saharan-whatsapp,,WHATSAPP-01,,,Joseph Rowe,qcook@gmail.com,001-068-037-9261,,Mark Baxter,57109 Laurie Shoal,,,,,,,,,United States,US,NY,New York,,
291,1/15/20 6:49pm,Bandcamp,album,Music from Saharan WhatsApp,Etran de L'Aïr,USD,3.0,1.0,,3.0,,,,0.23,paypal,3.0,0.0,249789018,,0.3,0.3,0.0,2.47,318.65,2.47,digital download,,http://etrandelair.bandcamp.com/album/music-from-saharan-whatsapp,,WHATSAPP-01,,,James Thomas,vaughnana@gmail.com,165-835-3563x911,,Lisa Smith,80349 Lee Plaza Apt. 936,,,,,,,,,United Kingdom,GB,Hackney,Stoke Newington,,
292,1/15/20 6:56pm,Bandcamp,album,Tiris,El Wali,USD,7.0,1.0,,7.0,,,,0.4,credit card,7.0,0.0,3611254091,,0.7,0.7,0.0,5.9,324.55,5.9,digital download,,http://elwali.bandcamp.com/album/tiris,,SS-055,602318 136923,,Derek Ortiz,martinnicholas@jones.com,040.574.0663x2606,,Donna Jones,17002 Murphy Mount,,,,,,,,,United States,US,NY,Brooklyn,,
293,1/15/20 6:56pm,Bandcamp,album,Music from Saharan WhatsApp,Etran de L'Aïr,USD,2.0,1.0,,2.0,,,,0.17,credit card,2.0,0.0,3027623453,,0.2,0.2,0.0,1.63,326.18,1.63,digital download,,http://etrandelair.bandcamp.com/album/music-from-saharan-whatsapp,,WHATSAPP-01,,,Dustin Vasquez,travismoore@rodriguez-williams.org,(510)023-6022,,Paula Griffith,561 Joanna Highway,,,,,,,,,Italy,IT,Provincia di Latina,Latina,,
294,1/15/20 6:59pm,Bandcamp,album,Music from Saharan WhatsApp,Etran de L'Aïr,USD,1.0,1.0,,1.0,,,,0.1,credit card,1.0,0.0,4128322221,,0.1,0.1,0.0,0.8,326.98,0.8,digital download,,http://etrandelair.bandcamp.com/album/music-from-saharan-whatsapp,,WHATSAPP-01,,,Courtney Fitzgerald,gatesraymond@hotmail.com,040-290-1715,,Ann Reed,22792 Katherine Glens Suite 396,,,,,,,,,United States,US,IL,Chicago,,
295,1/15/20 7:06pm,Bandcamp,album,Music from Saharan WhatsApp,Etran de L'Aïr,USD,1.0,1.0,,1.0,,,,0.11,paypal,1.0,0.0,3853811958,,0.1,0.1,0.0,0.79,327.77,0.79,digital download,,http://etrandelair.bandcamp.com/album/music-from-saharan-whatsapp,,WHATSAPP-01,,,Michelle Burton,matthewbrown@yahoo.com,(976)145-1753x71021,,Michael Haynes,70975 Lucas Views,,,,,,,,,Netherlands,NL,North Holland,Krommenie,Facebook,www.facebook.com
296,1/15/20 7:12pm,Bandcamp,album,Music from Saharan WhatsApp,Etran de L'Aïr,USD,5.0,1.0,,5.0,,,,0.3,paypal,5.0,0.0,1191865532,,0.5,0.5,0.0,4.2,331.97,4.2,digital download,,http://etrandelair.bandcamp.com/album/music-from-saharan-whatsapp,,WHATSAPP-01,,,Philip Johnson,craigdavies@yahoo.com,688.314.0117,,Adam Johnson,02760 Victoria Well,,,,,,,,,United States,US,CA,Los Angeles,,
297,1/15/20 7:17pm,Bandcamp,album,Music from Saharan WhatsApp,Etran de L'Aïr,USD,3.0,1.0,,3.0,,,,0.2,credit card,3.0,0.0,1131236841,,0.3,0.3,0.0,2.5,334.47,2.5,digital download,,http://etrandelair.bandcamp.com/album/music-from-saharan-whatsapp,,WHATSAPP-01,,,Joshua Keith,pamela59@holmes-schneider.com,+1-572-939-1432,,Stephanie James,0027 Mark Pine,,,,,,,,,United States,US,CA,El Cerrito,Bandcamp New & Notable,bandcamp.com/#new-notable
298,1/15/20 7:17pm,Bandcamp,package,Ilana: The Creator,Mdou Moctar,USD,18.0,1.0,,18.0,,5.0,United States,0.81,credit card,23.0,0.0,482034292,,1.8,1.8,0.0,20.39,354.86,15.39,Ilana LP,,http://mdoumoctar.bandcamp.com/album/ilana-the-creator,SS-051lp,SS-051,602318 136893,,Amanda Morrow,zstein@gmail.com,(329)925-0672x441,,Maria Holland,88677 William Ports,,Avondale,AZ,85392,United States,US,1/21/20,,United States,US,AZ,Avondale,,
299,1/15/20 7:20pm,Bandcamp,album,Music from Saharan WhatsApp,Etran de L'Aïr,USD,3.0,1.0,,3.0,,,,0.2,credit card,3.0,0.0,3414446130,,0.3,0.3,0.0,2.5,357.36,2.5,digital download,,http://etrandelair.bandcamp.com/album/music-from-saharan-whatsapp,,WHATSAPP-01,,,Thomas Allen,dreeves@thomas.org,+1-570-707-0559x664,,Michael Brown,4862 Page Grove Suite 332,,,,,,,,,United States,US,CA,Los Angeles,,
300,1/15/20 7:24pm,Bandcamp,album,Music from Saharan WhatsApp,Etran de L'Aïr,USD,3.0,1.0,,3.0,,,,0.2,paypal,3.0,0.0,2043146724,,0.3,0.3,0.0,2.5,359.86,2.5,digital download,,http://etrandelair.bandcamp.com/album/music-from-saharan-whatsapp,,WHATSAPP-01,,,Matthew Hubbard,xweber@yahoo.com,689.755.7488x4743,,Tara Howard,9962 Richard Creek,,,,,,,,,United States,US,CA,Los Angeles,Publish notice sent to your fans,
301,1/15/20 7:34pm,Bandcamp,album,Music from Saharan WhatsApp,Etran de L'Aïr,USD,5.0,1.0,,5.0,,,,0.35,paypal,5.0,0.0,394354784,,0.5,0.5,0.0,4.15,364.01,4.15,digital download,,http://etrandelair.bandcamp.com/album/music-from-saharan-whatsapp,,WHATSAPP-01,,,Julia Clark,campbellclarence@reynolds.biz,595-582-4304x5060,,Lisa Banks,40103 Murray Mountains Apt. 987,,,,,,,,,United Kingdom,GB,Somerset,Bruton,Bandcamp artist: etrandelair,etrandelair.bandcamp.com/album/music-from-saharan-whatsapp
302,1/15/20 7:39pm,Bandcamp,album,Music from Saharan WhatsApp,Etran de L'Aïr,USD,5.0,1.0,,5.0,,,,0.3,paypal,5.0,0.0,4001345932,,0.5,0.5,0.0,4.2,368.21,4.2,digital download,,http://etrandelair.bandcamp.com/album/music-from-saharan-whatsapp,,WHATSAPP-01,,,Jeanne Hall,joseph67@rodriguez-ramos.com,948.814.0870x075,,Michael Williams,928 Whitney Tunnel Apt. 091,,,,,,,,,United States,US,CA,Berkeley,,
303,1/15/20 8:05pm,Bandcamp,package,Tiris,El Wali,USD,17.0,1.0,,17.0,,5.0,United States,0.78,credit card,22.0,0.0,3341098989,,1.7,1.7,0.0,19.52,387.73,14.52,Tiris LP,,http://elwali.bandcamp.com/album/tiris,SS-055lp,SS-055,602318 136923,,Brandon Lane,timothyhebert@anthony.com,001-292-834-7643x7205,,Kimberly Lewis,38630 Vanessa Light,,Draper,UT,84020,United States,US,1/21/20,,United States,US,UT,Draper,Bandcamp search,bandcamp.com/autocomplete-search
304,1/15/20 8:10pm,Bandcamp,album,Music from Saharan WhatsApp,Etran de L'Aïr,USD,5.0,1.0,,5.0,,,,0.35,paypal,5.0,0.0,86148314,,0.5,0.5,0.0,4.15,391.88,4.15,digital download,,http://etrandelair.bandcamp.com/album/music-from-saharan-whatsapp,,WHATSAPP-01,,,Deborah Smith,ojefferson@gmail.com,+1-648-488-5936x1252,,Corey Joseph,631 Douglas Knoll Apt. 740,,,,,,,,,Sweden,SE,Värmland,Karlstad,Publish notice sent to your fans,
305,1/15/20 8:33pm,Bandcamp,album,Music from Saharan WhatsApp,Etran de L'Aïr,USD,5.0,1.0,,5.0,,,,0.3,paypal,5.0,0.0,1272655266,,0.5,0.5,0.0,4.2,396.08,4.2,digital download,,http://etrandelair.bandcamp.com/album/music-from-saharan-whatsapp,,WHATSAPP-01,,,Albert Arroyo,rachel69@yahoo.com,+1-770-292-3290x723,,Stacy Woodard,15216 Flores Drive Suite 897,,,,,,,,,United States,US,CA,Santa Monica,,
306,1/15/20 8:33pm,Bandcamp,album,Music from Saharan WhatsApp,Etran de L'Aïr,USD,4.0,1.0,,4.0,,,,0.25,paypal,4.0,0.0,1720399426,,0.4,0.4,0.0,3.35,399.43,3.35,digital download,,http://etrandelair.bandcamp.com/album/music-from-saharan-whatsapp,,WHATSAPP-01,,,Michael Molina,taylorandrew@gmail.com,(720)906-9054,,Michelle Nichols,1818 Zavala Manors,,,,,,,,,United States,US,NY,New York,Publish notice sent to your fans,
307,1/15/20 8:39pm,Bandcamp,album,Music from Saharan Cellphones,Various,USD,9.0,1.0,,9.0,1.33,,,0.6,paypal,10.33,0.0,1813268026,,0.9,0.9,0.0,7.5,406.93,7.5,digital download,,http://sahelsounds.bandcamp.com/album/music-from-saharan-cellphones,,SS-003,889326 667889,,Alan Hart,marytorres@hotmail.com,+1-834-184-5584x4068,,Anthony Booth,487 Lane Views Suite 069,,,,,,,,,Germany,DE,Rheinland-Pfalz,Mainz,Bandcamp fan wishlist,bandcamp.com/secondgoddess
308,1/15/20 8:40pm,Bandcamp,album,Music from Saharan WhatsApp,Etran de L'Aïr,USD,10.0,1.0,,10.0,,,,0.49,paypal,10.0,0.0,63533425,,1.0,1.0,0.0,8.51,415.44,8.51,digital download,,http://etrandelair.bandcamp.com/album/music-from-saharan-whatsapp,,WHATSAPP-01,,,Haley Ramirez,pennyharris@walker.info,313.270.2908,,Keith Sanders,13651 Shannon Views,,,,,,,,,United States,US,CO,Denver,Publish notice sent to your fans,
309,1/15/20 8:48pm,Bandcamp,album,Music from Saharan WhatsApp,Etran de L'Aïr,USD,10.0,1.0,,10.0,,,,0.59,paypal,10.0,0.0,638423448,,1.0,1.0,0.0,8.41,423.85,8.41,digital download,,http://etrandelair.bandcamp.com/album/music-from-saharan-whatsapp,,WHATSAPP-01,,,Joseph Mcmahon,laura85@bennett.net,(475)506-5176x05396,,Nina Romero,5469 Valerie Fords,,,,,,,,,United States,US,AZ,Phoenix,,
310,1/15/20 8:49pm,Bandcamp,album,Music from Saharan WhatsApp,Etran de L'Aïr,USD,2.0,1.0,,2.0,,,,0.17,paypal,2.0,0.0,2641909628,,0.2,0.2,0.0,1.63,425.48,1.63,digital download,,http://etrandelair.bandcamp.com/album/music-from-saharan-whatsapp,,WHATSAPP-01,,,Anita Jones,jasonolsen@gmail.com,979-179-2280x292,,Ronald Zimmerman,1167 Lindsay Alley Apt. 068,,,,,,,,,Qatar,QA,Baladiyat ad Dawhah,Doha,Bandcamp New & Notable,bandcamp.com/#new-notable
311,1/15/20 8:52pm,Bandcamp,album,Music from Saharan WhatsApp,Etran de L'Aïr,USD,3.0,1.0,,3.0,,,,0.2,credit card,3.0,0.0,375733602,,0.3,0.3,0.0,2.5,427.98,2.5,digital download,,http://etrandelair.bandcamp.com/album/music-from-saharan-whatsapp,,WHATSAPP-01,,,Douglas Smith,brianabrown@boyle.biz,(818)170-0996,,Crystal Cox,523 Murphy Village,,,,,,,,,United States,US,CA,Glendale,Publish notice sent to your fans,
312,1/15/20 9:09pm,Bandcamp,album,Music from Saharan WhatsApp,Etran de L'Aïr,USD,5.0,1.0,,5.0,,,,0.3,paypal,5.0,0.0,3886783859,,0.5,0.5,0.0,4.2,432.18,4.2,digital download,,http://etrandelair.bandcamp.com/album/music-from-saharan-whatsapp,,WHATSAPP-01,,,Robert Shaw,erica44@yahoo.com,785.873.4622,,Jason Johnson,6492 Timothy Pass,,,,,,,,,United States,US,CA,San Francisco,Bandcamp New & Notable,bandcamp.com/#new-notable
313,1/15/20 9:22pm,Bandcamp,album,Ilana: The Creator,Mdou Moctar,USD,9.0,1.0,,9.0,,,,0.64,paypal,9.0,0.0,758456613,,0.9,0.0,0.9,0.0,432.18,7.46,digital download,,http://mdoumoctar.bandcamp.com/album/ilana-the-creator,,SS-051,602318 136893,,Molly Willis,laurie86@hotmail.com,(952)916-9573,,April Rodriguez,7123 Harold Expressway,,,,,,,,,United States,US,MT,Bozeman,Recommendations footer: commonly collected,bandcamp.com/footer/cc/a3785769451
314,1/15/20 9:22pm,Bandcamp,album,Sousoume Tamachek,Mdou Moctar,USD,9.0,1.0,,9.0,,,,,,9.0,0.0,758456613,,0.9,1.8,0.0,15.56,447.74,8.1,digital download,,http://mdoumoctar.bandcamp.com/album/sousoume-tamachek,,SS-043,191515 769435,,Tiffany Hernandez,schmidtsarah@estrada.net,608.703.7891,,Emily Ramos,09088 Elizabeth Land,,,,,,,,,United States,US,MT,Bozeman,Recommendations footer: commonly collected,bandcamp.com/footer/cc/a3785769451
315,1/15/20 9:43pm,Bandcamp,album,Uchronia – Field Recordings From Alternate Realities,Sahel Sounds,USD,1.0,1.0,,1.0,,,,0.11,paypal,1.0,0.0,3191688701,,0.1,0.1,0.0,0.79,448.53,0.79,digital download,,http://sahelsounds.bandcamp.com/album/uchronia-field-recordings-from-alternate-realities,,SS-000,,,Christopher Castillo,tammy20@williams-cook.info,071-875-4965x66509,,Timothy Kent,64866 Rivera Causeway,,,,,,,,,Spain,ES,Barcelona,Barcelona,Bandcamp fan wishlist,bandcamp.com/fibreglass
316,1/15/20 10:12pm,Bandcamp,album,Music from Saharan WhatsApp,Etran de L'Aïr,USD,10.0,1.0,,10.0,,,,0.59,paypal,10.0,0.0,1140722191,,1.0,1.0,0.0,8.41,456.94,8.41,digital download,,http://etrandelair.bandcamp.com/album/music-from-saharan-whatsapp,,WHATSAPP-01,,,Shawn Vang,barkercolleen@maxwell.com,362-865-5691x916,,Phillip Ramirez,73548 Davis Ridges,,,,,,,,,Australia,AU,NSW,Ultimo,Publish notice sent to your fans,
317,1/15/20 10:21pm,Bandcamp,album,Eghass Malan,Les Filles de Illighadad,USD,7.0,1.0,,7.0,1.75,,,0.58,credit card,8.75,0.0,3572499131,,0.7,0.7,0.0,5.72,462.66,5.72,digital download,,http://lesfillesdeillighadad.bandcamp.com/album/eghass-malan,,SS-044,191515 928351,,Timothy Wood,allenmeghan@johnson.com,+1-677-316-6709x77367,Great music. Please come to play in Denmark! Maybe in Loppen or Alice?,Wendy Burton,54162 Manuel Lock Suite 378,,,,,,,,,Denmark,DK,Capital Region,Copenhagen,,
318,1/15/20 10:24pm,Bandcamp,album,Music from Saharan WhatsApp,Etran de L'Aïr,USD,6.0,1.0,,6.0,,,,0.35,paypal,6.0,0.0,1178924796,,0.6,0.6,0.0,5.05,467.71,5.05,digital download,,http://etrandelair.bandcamp.com/album/music-from-saharan-whatsapp,,WHATSAPP-01,,,Robert Thomas,neil87@yahoo.com,8455385547,,Leonard Thornton,572 Burch Alley Suite 945,,,,,,,,,United States,US,MN,Minneapolis,Publish notice sent to your fans,
319,1/15/20 10:25pm,Bandcamp,album,Sahel Sounds Label Sampler,Various Artists,USD,4.0,1.0,,4.0,,,,0.29,credit card,4.0,0.0,531075969,,0.4,0.4,0.0,3.31,471.02,3.31,digital download,,http://sahelsounds.bandcamp.com/album/sahel-sounds-label-sampler,,SS-058,602318 137111,,Elizabeth Evans,brooke35@taylor-carroll.com,001-356-470-4761,,Selena Garcia,00614 Lauren Forge,,,,,,,,,Denmark,DK,Capital Region,Copenhagen,bandcamp.com,bandcamp.com
320,1/15/20 10:26pm,Bandcamp,album,Music from Saharan WhatsApp,Etran de L'Aïr,USD,1.0,1.0,,1.0,,,,0.11,paypal,1.0,0.0,4110900348,,0.1,0.1,0.0,0.79,471.81,0.79,digital download,,http://etrandelair.bandcamp.com/album/music-from-saharan-whatsapp,,WHATSAPP-01,,,Nicole Ortiz,mandyallison@watson.net,125.296.7449,,Robert Simmons,0066 White Isle Suite 845,,,,,,,,,United Kingdom,GB,Manchester,Manchester,,
321,1/15/20 10:33pm,Bandcamp,album,Music from Saharan WhatsApp,Etran de L'Aïr,USD,6.0,1.0,,6.0,,,,0.35,credit card,6.0,0.0,1478461409,,0.6,0.6,0.0,5.05,476.86,5.05,digital download,,http://etrandelair.bandcamp.com/album/music-from-saharan-whatsapp,,WHATSAPP-01,,,Rachel Sims,troyphillips@reynolds.com,047-161-3918,,Mark Kennedy,307 Salas Meadow,,,,,,,,,United States,US,MN,Minneapolis,Bandcamp artist: etrandelair,etrandelair.bandcamp.com
322,1/15/20 10:36pm,Bandcamp,album,Music from Saharan WhatsApp,Etran de L'Aïr,USD,4.0,1.0,,4.0,,,,0.29,credit card,4.0,0.0,1125814948,,0.4,0.4,0.0,3.31,480.17,3.31,digital download,,http://etrandelair.bandcamp.com/album/music-from-saharan-whatsapp,,WHATSAPP-01,,,Antonio Bauer,martineztammy@hernandez.com,810-888-2145x785,,Julia Clark,924 Lee Key,,,,,,,,,Canada,CA,ON,Toronto,l.instagram.com,l.instagram.com/
323,1/15/20 10:50pm,Bandcamp,album,Music from Saharan WhatsApp,Etran de L'Aïr,USD,1.0,1.0,,1.0,,,,0.1,credit card,1.0,0.0,2360480476,,0.1,0.1,0.0,0.8,480.97,0.8,digital download,,http://etrandelair.bandcamp.com/album/music-from-saharan-whatsapp,,WHATSAPP-01,,,Phillip Garrison,jonathan52@hotmail.com,(016)329-6478,,David Krueger,8046 Lyons Ridges Apt. 774,,,,,,,,,United States,US,CA,San Lorenzo,Bandcamp music feed: functime - jedwardkeyes,http://blog.bandcamp.com/2013/09/19/strap-on-your-feed-bag/
324,1/15/20 10:52pm,Bandcamp,album,Music from Saharan WhatsApp,Etran de L'Aïr,USD,1.0,1.0,,1.0,,,,0.11,credit card,1.0,0.0,4099934331,,0.1,0.1,0.0,0.79,481.76,0.79,digital download,,http://etrandelair.bandcamp.com/album/music-from-saharan-whatsapp,,WHATSAPP-01,,,Donna Harper,jonathan69@combs.com,4378723629,,Deborah Ramos,08630 Michael Tunnel Suite 143,,,,,,,,,New Zealand,NZ,Auckland,Auckland,,
325,1/15/20 11:03pm,Bandcamp,album,Music from Saharan WhatsApp,Etran de L'Aïr,USD,3.0,1.0,,3.0,,,,0.23,paypal,3.0,0.0,711778317,,0.3,0.3,0.0,2.47,484.23,2.47,digital download,,http://etrandelair.bandcamp.com/album/music-from-saharan-whatsapp,,WHATSAPP-01,,,Marissa Ramirez,qtaylor@hotmail.com,(129)394-4462x3589,,Alex Aguilar,700 Alexandra Square,,,,,,,,,United Kingdom,GB,Angus,Montrose,,
326,1/15/20 11:04pm,Bandcamp,album,Music from Saharan WhatsApp,Etran de L'Aïr,USD,2.0,1.0,,2.0,,,,0.17,paypal,2.0,0.0,3871187738,,0.2,0.2,0.0,1.63,485.86,1.63,digital download,,http://etrandelair.bandcamp.com/album/music-from-saharan-whatsapp,,WHATSAPP-01,,,Kim Johns,kayla07@yahoo.com,163-193-1141x8590,,Andrea Howe,616 Cook Crossroad Suite 912,,,,,,,,,Australia,AU,NSW,Wollongong,Facebook,m.facebook.com
327,1/15/20 11:07pm,Bandcamp,album,Music from Saharan WhatsApp,Etran de L'Aïr,USD,5.0,1.0,,5.0,,,,0.35,paypal,5.0,0.0,1384616841,,0.5,0.5,0.0,4.15,490.01,4.15,digital download,,http://etrandelair.bandcamp.com/album/music-from-saharan-whatsapp,,WHATSAPP-01,,,Jessica York,smithkristin@yahoo.com,790-691-7461x259,,Danielle Reeves,8030 Smith Lane Suite 665,,,,,,,,,United Kingdom,GB,Cornwall,Ponsanooth,Bandcamp music feed,http://blog.bandcamp.com/2014/01/30/bandcamp-app-now-with-music-feed/
328,1/15/20 11:30pm,Bandcamp,album,Music from Saharan WhatsApp,Etran de L'Aïr,USD,7.0,1.0,,7.0,,,,0.4,paypal,7.0,0.0,3363674633,,0.7,0.7,0.0,5.9,495.91,5.9,digital download,,http://etrandelair.bandcamp.com/album/music-from-saharan-whatsapp,,WHATSAPP-01,,,Christina Green,wayne75@hudson-perez.com,+1-284-524-5439x945,,Jessica Weaver,75996 Gregory Pines,,,,,,,,,United States,US,OR,Portland,,
329,1/15/20 11:34pm,Bandcamp,album,Music from Saharan WhatsApp,Etran de L'Aïr,USD,3.0,1.0,,3.0,,,,0.2,paypal,3.0,0.0,3623872237,,0.3,0.3,0.0,2.5,498.41,2.5,digital download,,http://etrandelair.bandcamp.com/album/music-from-saharan-whatsapp,,WHATSAPP-01,,,Jasmine Taylor,angelavasquez@hotmail.com,565.915.0835,,Christopher Ortiz,311 Hubbard Heights Apt. 007,,,,,,,,,United States,US,NY,Brooklyn,Bandcamp fan wishlist,bandcamp.com/madsen
330,1/15/20 11:37pm,Bandcamp,album,Music from Saharan WhatsApp,Etran de L'Aïr,USD,5.0,1.0,,5.0,,,,0.3,paypal,5.0,0.0,2974005889,,0.5,0.5,0.0,4.2,502.61,4.2,digital download,,http://etrandelair.bandcamp.com/album/music-from-saharan-whatsapp,,WHATSAPP-01,,,Ryan White,andrewslaura@dyer.com,877-050-8115x967,,Andrew Santana,1302 Dustin Fork Apt. 371,,,,,,,,,United States,US,VT,Thetford Center,,
331,1/15/20 11:46pm,Bandcamp,package,Afous d'Afous - Tarhanine Tegla,Afous d'Afous,USD,8.0,1.0,,8.0,,5.0,United States,0.59,credit card,13.0,0.0,2643448781,,0.8,0.8,0.0,11.61,514.22,6.61,Limited 7'' vinyl of Afous d'Afous,,http://afousdafous.bandcamp.com/album/afous-dafous-tarhanine-tegla,SS-035-7,SS-035,889326 668961,,Tracy Williams,alexander13@clark-pace.org,(259)393-5378,,Scott Patterson,91934 Miller Rapid Apt. 782,,Las Vegas,NV,89138,United States,US,1/21/20,,United States,US,NV,Las Vegas,Bandcamp home page,bandcamp.com/
332,1/15/20 11:56pm,Bandcamp,album,Music from Saharan WhatsApp,Etran de L'Aïr,USD,3.0,1.0,,3.0,,,,0.23,paypal,3.0,0.0,3530767811,,0.3,0.3,0.0,2.47,516.69,2.47,digital download,,http://etrandelair.bandcamp.com/album/music-from-saharan-whatsapp,,WHATSAPP-01,,,Tiffany Aguirre,sanderslinda@roy-kelly.com,552-573-5053x8262,,Jerry Henderson,8966 Andrew View,,,,,,,,,United Kingdom,GB,Sheffield,Sheffield,Twitter,t.co/1YMVMYCIbh?amp=1
333,1/15/20 11:57pm,Bandcamp,album,Music from Saharan WhatsApp,Etran de L'Aïr,USD,1.0,1.0,,1.0,,,,0.1,credit card,1.0,0.0,1858841225,,0.1,0.1,0.0,0.8,517.49,0.8,digital download,,http://etrandelair.bandcamp.com/album/music-from-saharan-whatsapp,,WHATSAPP-01,,,Danielle Melendez,christine51@yahoo.com,(774)883-4857,Love that whatsapp is the successor to cellphones.,Kimberly Wise,317 Kurt Mountain Apt. 760,,,,,,,,,United States,US,CA,Los Angeles,Google search,www.google.com/
334,1/16/20 12:13am,Bandcamp,album,Music from Saharan WhatsApp,Etran de L'Aïr,USD,5.0,1.0,,5.0,,,,0.3,paypal,5.0,0.0,1965992226,,0.5,0.5,0.0,4.2,521.69,4.2,digital download,,http://etrandelair.bandcamp.com/album/music-from-saharan-whatsapp,,WHATSAPP-01,,,Kara Christensen,tyler05@hotmail.com,(905)980-2093x634,,Kristin Larson,04693 Rogers Pine Suite 284,,,,,,,,,United States,US,MO,St Louis,,
335,1/16/20 12:47am,Bandcamp,album,Music from Saharan WhatsApp,Etran de L'Aïr,USD,1.0,1.0,,1.0,,,,0.1,paypal,1.0,0.0,630917474,,0.1,0.1,0.0,0.8,522.49,0.8,digital download,,http://etrandelair.bandcamp.com/album/music-from-saharan-whatsapp,,WHATSAPP-01,,,Edward May,kenneth90@gmail.com,001-883-220-8811,,Jacqueline Smith,063 Wallace Extension,,,,,,,,,United States,US,NC,Chapel Hill,,
336,1/16/20 12:51am,Bandcamp,album,Music from Saharan WhatsApp,Etran de L'Aïr,USD,10.0,1.0,,10.0,,,,0.49,paypal,10.0,0.0,3394772607,,1.0,1.0,0.0,8.51,531.0,8.51,digital download,,http://etrandelair.bandcamp.com/album/music-from-saharan-whatsapp,,WHATSAPP-01,,,George Li,keithderrick@bell-jackson.biz,001-099-956-7408x443,,Jackie Gonzalez,73816 Roman Row,,,,,,,,,United States,US,PA,Pittsburgh,,
337,1/16/20 1:21am,Bandcamp,album,Music from Saharan WhatsApp,Etran de L'Aïr,USD,5.0,1.0,,5.0,,,,0.35,credit card,5.0,0.0,3567772284,,0.5,0.5,0.0,4.15,535.15,4.15,digital download,,http://etrandelair.bandcamp.com/album/music-from-saharan-whatsapp,,WHATSAPP-01,,,Melissa Smith,april36@yahoo.com,(022)442-3588x0733,,Kelly Carlson,4734 Gamble Burgs Suite 067,,,,,,,,,New Zealand,NZ,Canterbury,Christchurch,,
338,1/16/20 1:55am,Bandcamp,album,Music from Saharan WhatsApp,Etran de L'Aïr,USD,3.0,1.0,,3.0,,,,0.23,paypal,3.0,0.0,1699115819,,0.3,0.3,0.0,2.47,537.62,2.47,digital download,,http://etrandelair.bandcamp.com/album/music-from-saharan-whatsapp,,WHATSAPP-01,,,Kristin Carlson,vwong@gmail.com,006.534.7914x095,,Adam Riley,00448 Nancy Vista Suite 952,,,,,,,,,Australia,AU,VIC,Melbourne,,
339,1/16/20 2:56am,Bandcamp,package,Mali Kady,Luka Productions,USD,8.0,1.0,,8.0,,4.0,United States,0.53,paypal,12.0,0.0,1043538595,,0.8,0.8,0.0,10.67,548.29,6.67,Luka Productions Cassette,,http://lukaproductions.bandcamp.com/album/mali-kady,SSC-016cass,SSC-016,889326 664925,,Briana Young,jonesjulia@yahoo.com,+1-191-938-9218x9598,,Jared Holt,12935 Christine Ways,Apt C3,Deerfield Beach,FL,33442,United States,US,1/21/20,,United States,US,FL,Deerfield Beach,,
340,1/16/20 3:06am,Bandcamp,album,Music from Saharan WhatsApp,Etran de L'Aïr,USD,1.0,1.0,,1.0,,,,0.1,paypal,1.0,0.0,2088870916,,0.1,0.1,0.0,0.8,549.09,0.8,digital download,,http://etrandelair.bandcamp.com/album/music-from-saharan-whatsapp,,WHATSAPP-01,,,Mary Jones,cglenn@hotmail.com,001-959-385-4568x42587,,Miranda Harding,496 Davis Crescent Suite 587,,,,,,,,,United States,US,CA,Los Angeles,,
341,1/16/20 3:11am,Bandcamp,album,Music from Saharan WhatsApp,Etran de L'Aïr,USD,10.0,1.0,,10.0,,,,0.52,credit card,10.0,0.0,328243391,,1.0,1.0,0.0,8.48,557.57,8.48,digital download,,http://etrandelair.bandcamp.com/album/music-from-saharan-whatsapp,,WHATSAPP-01,,,Stephanie Garrett,bridget26@gmail.com,666-551-1344x948,,Thomas Banks,1154 Lance Drive,,,,,,,,,United States,US,NY,New York,,
342,1/16/20 3:21am,Bandcamp,album,Music from Saharan WhatsApp,Etran de L'Aïr,USD,1.0,1.0,,1.0,,,,0.1,paypal,1.0,0.0,3941874548,,0.1,0.1,0.0,0.8,558.37,0.8,digital download,,http://etrandelair.bandcamp.com/album/music-from-saharan-whatsapp,,WHATSAPP-01,,,Chelsea Turner,john39@perry-rice.com,+1-180-793-8010x2121,,Donna Vargas,554 Sheila Extensions,,,,,,,,,United States,US,OR,Corvallis,Publish notice sent to your fans,
343,1/16/20 3:43am,Bandcamp,album,Music from Saharan WhatsApp,Etran de L'Aïr,USD,1.0,1.0,,1.0,,,,0.11,credit card,1.0,0.0,3184012578,,0.1,0.1,0.0,0.79,559.16,0.79,digital download,,http://etrandelair.bandcamp.com/album/music-from-saharan-whatsapp,,WHATSAPP-01,,,Greg Taylor,sarahharris@gmail.com,+1-352-013-1217x215,,Luis Adams,27843 Ashley Coves,,,,,,,,,New Zealand,NZ,Waikato,Hamilton,Bandcamp fan wishlist,bandcamp.com/haminoon
344,1/16/20 3:48am,Bandcamp,album,Music from Saharan WhatsApp,Etran de L'Aïr,USD,1.0,1.0,,1.0,,,,0.11,credit card,1.0,0.0,110417859,,0.1,0.1,0.0,0.79,559.95,0.79,digital download,,http://etrandelair.bandcamp.com/album/music-from-saharan-whatsapp,,WHATSAPP-01,,,Sandra Hernandez,carlydavis@herring.biz,+1-712-597-0872x9100,,George Franklin,50976 Rachael Point Apt. 017,,,,,,,,,Mexico,MX,Baja California,Tijuana,Bandcamp search,bandcamp.com/autocomplete-search
345,1/16/20 3:52am,Bandcamp,album,Music from Saharan WhatsApp,Etran de L'Aïr,USD,2.0,1.0,,2.0,,,,0.15,paypal,2.0,0.0,288877086,,0.2,0.2,0.0,1.65,561.6,1.65,digital download,,http://etrandelair.bandcamp.com/album/music-from-saharan-whatsapp,,WHATSAPP-01,,,Michele Warren,paul64@gmail.com,+1-974-210-8326x895,,Jessica Brown,30082 David Underpass,,,,,,,,,United States,US,WA,Seattle,Bandcamp sales feed,bandcamp.com/#selling-now
346,1/16/20 4:11am,Bandcamp,album,Music from Saharan Cellphones,Various,USD,7.0,1.0,,7.0,,,,0.57,paypal,7.0,0.0,723023457,,0.7,0.0,0.7,0.0,561.6,5.73,digital download,,http://sahelsounds.bandcamp.com/album/music-from-saharan-cellphones,,SS-003,889326 667889,,Lisa Rogers,heidihamilton@armstrong.com,850-783-6770x391,,Olivia Mitchell,065 Stephanie Walk,,,,,,,,,United States,US,MA,Jamaica Plain,Google search,www.google.com/
347,1/16/20 4:11am,Bandcamp,album,Balani Show Super Hits: Electronic Street Parties from Mali,Various,USD,7.0,1.0,,7.0,,,,,,7.0,0.0,723023457,,0.7,1.4,0.0,12.03,573.63,6.3,digital download,,http://sahelsounds.bandcamp.com/album/balani-show-super-hits-electronic-street-parties-from-mali,,SS-021,889326 667643,,Kathleen Morris,kimberlypowell@schmidt.org,+1-519-688-3286x7837,,Sean Lewis,4978 Jason Wall Suite 198,,,,,,,,,United States,US,MA,Jamaica Plain,Google search,www.google.com/
348,1/16/20 4:43am,Bandcamp,album,Music from Saharan WhatsApp,Etran de L'Aïr,USD,4.0,1.0,,4.0,,,,0.29,paypal,4.0,0.0,2809910878,,0.4,0.4,0.0,3.31,576.94,3.31,digital download,,http://etrandelair.bandcamp.com/album/music-from-saharan-whatsapp,,WHATSAPP-01,,,Erin Ellis,ashleymitchell@myers-nash.com,9469235952,,Adrian Thompson,96895 Peter Crossroad,,,,,,,,,Australia,AU,VIC,Fitzroy,,
349,1/16/20 4:49am,Bandcamp,album,Music from Saharan Cellphones,Various,USD,7.0,1.0,,7.0,,,,0.4,credit card,7.0,0.0,636221222,,0.7,0.7,0.0,5.9,582.84,5.9,digital download,,http://sahelsounds.bandcamp.com/album/music-from-saharan-cellphones,,SS-003,889326 667889,,Anna Hicks,amccoy@yahoo.com,(711)370-4981x2855,,Michael Jacobs,6646 Murray Extensions,,,,,,,,,United States,US,DC,Washington,t.umblr.com,t.umblr.com/
350,1/16/20 4:53am,Bandcamp,album,Music from Saharan WhatsApp,Etran de L'Aïr,USD,5.0,1.0,,5.0,,,,0.3,paypal,5.0,0.0,1240197884,,0.5,0.5,0.0,4.2,587.04,4.2,digital download,,http://etrandelair.bandcamp.com/album/music-from-saharan-whatsapp,,WHATSAPP-01,,,David Davis,patelsean@yahoo.com,(028)406-8389x797,,Jennifer Byrd,8411 Barbara Crescent,,,,,,,,,United States,US,VA,Charlottesville,Bandcamp release notification: music feed,http://blog.bandcamp.com/2014/01/30/bandcamp-app-now-with-music-feed/
351,1/16/20 4:59am,Bandcamp,album,Music from Saharan WhatsApp,Etran de L'Aïr,USD,3.0,1.0,,3.0,,,,0.2,paypal,3.0,0.0,1524730925,,0.3,0.3,0.0,2.5,589.54,2.5,digital download,,http://etrandelair.bandcamp.com/album/music-from-saharan-whatsapp,,WHATSAPP-01,,,Matthew Carr,robertcruz@yahoo.com,574.147.2845x2205,,Barbara Salazar,903 Bradley Alley,,,,,,,,,United States,US,CA,Santa Barbara,Publish notice sent to your fans,
352,1/16/20 6:38am,Bandcamp,album,Music from Saharan WhatsApp,Etran de L'Aïr,USD,3.0,1.0,,3.0,,,,0.23,paypal,3.0,0.0,2447555956,,0.3,0.3,0.0,2.47,592.01,2.47,digital download,,http://etrandelair.bandcamp.com/album/music-from-saharan-whatsapp,,WHATSAPP-01,,,Travis Daniels,chadreynolds@hotmail.com,482-226-7043x69772,,Dean Russell,41093 Christopher Highway Apt. 279,,,,,,,,,Germany,DE,Bavaria,Lauingen,Facebook,www.facebook.com
353,1/16/20 6:39am,Bandcamp,album,Music from Saharan WhatsApp,Etran de L'Aïr,USD,3.0,1.0,,3.0,,,,0.2,credit card,3.0,0.0,4027770484,,0.3,0.3,0.0,2.5,594.51,2.5,digital download,,http://etrandelair.bandcamp.com/album/music-from-saharan-whatsapp,,WHATSAPP-01,,,Matthew Henry,yfowler@brown.info,564-242-6644x63010,,Mark Simon,18566 Goodman Green Suite 103,,,,,,,,,United States,US,CA,San Diego,Bandcamp fan wishlist,bandcamp.com/sleezsisters
354,1/16/20 7:25am,Bandcamp,album,Music from Saharan WhatsApp,Etran de L'Aïr,USD,2.0,1.0,,2.0,,,,0.17,paypal,2.0,0.0,3631367910,,0.2,0.2,0.0,1.63,596.14,1.63,digital download,,http://etrandelair.bandcamp.com/album/music-from-saharan-whatsapp,,WHATSAPP-01,,,Caroline Martin,rsanders@hodges.org,+1-351-830-4122x6356,,Cheyenne Wilson,88021 Mccullough Route Suite 064,,,,,,,,,Burkina Faso,BF,Kadiogo Province,Ouagadougou,,
355,1/16/20 9:32am,Bandcamp,album,Music from Saharan WhatsApp,Etran de L'Aïr,USD,2.0,1.0,,2.0,,,,0.17,credit card,2.0,0.0,2992368417,,0.2,0.2,0.0,1.63,597.77,1.63,digital download,,http://etrandelair.bandcamp.com/album/music-from-saharan-whatsapp,,WHATSAPP-01,,,Tony Martinez,kimberly07@weaver-ruiz.com,001-202-092-1067x393,,Timothy Woods,4474 Zachary Circles,,,,,,,,,Belgium,BE,East Flanders Province,Ghent,Bandcamp music feed,http://blog.bandcamp.com/2014/01/30/bandcamp-app-now-with-music-feed/
356,1/16/20 11:32am,Bandcamp,album,Music from Saharan WhatsApp,Etran de L'Aïr,USD,1.0,1.0,,1.0,,,,0.11,paypal,1.0,0.0,1061504595,,0.1,0.1,0.0,0.79,598.56,0.79,digital download,,http://etrandelair.bandcamp.com/album/music-from-saharan-whatsapp,,WHATSAPP-01,,,Susan Bryant,clementssteven@lara.net,931.128.5486,,Katie Hernandez,0934 Justin Village,,,,,,,,,Germany,DE,Land Berlin,Berlin,Bandcamp release notification: music feed,http://blog.bandcamp.com/2013/09/19/strap-on-your-feed-bag/
357,1/16/20 12:28pm,Bandcamp,album,Music from Saharan WhatsApp,Etran de L'Aïr,USD,2.0,1.0,,2.0,,,,0.17,paypal,2.0,0.0,3163007952,,0.2,0.2,0.0,1.63,600.19,1.63,digital download,,http://etrandelair.bandcamp.com/album/music-from-saharan-whatsapp,,WHATSAPP-01,,,Brett Watson,kcollins@evans.com,566-278-0222x03183,,Daniel Romero,0959 Kim Locks Suite 363,,,,,,,,,Netherlands,NL,North Brabant,Breda,,
358,1/16/20 1:14pm,Bandcamp,album,Music from Saharan WhatsApp,Etran de L'Aïr,USD,3.0,1.0,,3.0,,,,0.2,paypal,3.0,0.0,2777386361,,0.3,0.3,0.0,2.5,602.69,2.5,digital download,,http://etrandelair.bandcamp.com/album/music-from-saharan-whatsapp,,WHATSAPP-01,,,Shannon Harrison,chancandace@hotmail.com,065.554.0561,,Gregory Elliott,07851 Thomas Ferry,,,,,,,,,United States,US,NC,Raleigh,Bandcamp music feed,http://blog.bandcamp.com/2014/01/30/bandcamp-app-now-with-music-feed/
359,1/16/20 1:36pm,Bandcamp,album,Music from Saharan WhatsApp,Etran de L'Aïr,USD,1.0,1.0,,1.0,,,,0.1,credit card,1.0,0.0,64021679,,0.1,0.1,0.0,0.8,603.49,0.8,digital download,,http://etrandelair.bandcamp.com/album/music-from-saharan-whatsapp,,WHATSAPP-01,,,Richard Wright,pvillegas@yahoo.com,(857)317-9469x293,,Teresa Scott,500 Barnett Courts Apt. 874,,,,,,,,,United States,US,PA,Perkasie,Publish notice sent to your fans,
360,1/16/20 2:45pm,Bandcamp,album,Music from Saharan WhatsApp,Etran de L'Aïr,USD,7.0,1.0,,7.0,,,,0.47,paypal,7.0,0.0,4039769396,,0.7,0.7,0.0,5.83,609.32,5.83,digital download,,http://etrandelair.bandcamp.com/album/music-from-saharan-whatsapp,,WHATSAPP-01,,,Marcus Sheppard,nfletcher@campbell.com,001-632-572-1644,,Dwayne Jenkins,41562 Johnston Forks,,,,,,,,,United Kingdom,GB,Lambeth,Streatham,Bandcamp search: “saharan whatsapp”,bandcamp.com/search?q=saharan%20whatsapp
361,1/16/20 2:47pm,Bandcamp,album,Sahel Sounds Label Sampler,Various Artists,USD,3.0,1.0,,3.0,,,,0.23,paypal,3.0,0.0,2868585732,,0.3,0.3,0.0,2.47,611.79,2.47,digital download,,http://sahelsounds.bandcamp.com/album/sahel-sounds-label-sampler,,SS-058,602318 137111,,Kimberly Nguyen,christy15@gmail.com,7228505988,,Stephanie Schultz,0133 Brendan Trafficway,,,,,,,,,United Kingdom,GB,Lambeth,Streatham,bandcamp.com,bandcamp.com
362,1/16/20 3:14pm,Bandcamp,album,Houmeissa,Hama,USD,10.0,1.0,,10.0,,,,0.62,credit card,10.0,0.0,4151719855,,1.0,1.0,0.0,8.38,620.17,8.38,digital download,,http://hamasynth.bandcamp.com/album/houmeissa,,SS-049,656605 382364,,Brittany Hawkins,amy54@lynn.biz,321.851.5520x304,,Richard Hodge,9326 Wolf Lakes,,,,,,,,,Canada,CA,,,Bandcamp Daily: the-best-albums-of-2019-80-61,daily.bandcamp.com/best-of-2019/the-best-albums-of-2019-80-61
363,1/16/20 3:21pm,Bandcamp,album,Tenere,Afous d'Afous,USD,7.0,1.0,,7.0,,,,0.4,paypal,7.0,0.0,3788384819,,0.7,0.7,0.0,5.9,626.07,5.9,digital download,,http://afousdafous.bandcamp.com/album/tenere,,SS-042,191515 490421,,Kelly Jones,zmills@gmail.com,727-147-2967,,Adam Roberts,69069 Martin Viaduct Apt. 586,,,,,,,,,United States,US,,,,
364,1/16/20 3:24pm,Bandcamp,album,Afous d'Afous - Tarhanine Tegla,Afous d'Afous,USD,4.0,1.0,,4.0,,,,0.25,paypal,4.0,0.0,457158665,,0.4,0.4,0.0,3.35,629.42,3.35,digital download,,http://afousdafous.bandcamp.com/album/afous-dafous-tarhanine-tegla,,SS-035,889326 668961,,Diana Dixon,jschwartz@leach-schmidt.com,001-088-722-1848x2796,,Charles Johnson,849 Kim Rapids,,,,,,,,,United States,US,,,,
365,1/16/20 3:33pm,Bandcamp,album,Music from Saharan WhatsApp,Etran de L'Aïr,USD,2.0,1.0,,2.0,,,,0.15,paypal,2.0,0.0,3915185707,,0.2,0.2,0.0,1.65,631.07,1.65,digital download,,http://etrandelair.bandcamp.com/album/music-from-saharan-whatsapp,,WHATSAPP-01,,,Christian Weber,desiree81@dudley.com,219.240.2876x721,,Gina Stewart,94069 Kyle Locks Apt. 349,,,,,,,,,United States,US,DC,Washington,,
366,1/16/20 3:47pm,Bandcamp,package,Ilana: The Creator,Mdou Moctar,USD,30.0,1.0,,30.0,,5.0,United States,1.07,credit card,35.0,0.0,4064743243,,3.0,3.0,0.0,30.93,662.0,25.93,Ilana: The Creator shirt,Small,http://mdoumoctar.bandcamp.com/merch/ilana-the-creator-shirt,SS-MDOU-BIRD-SHIRT-S,,,,Luis Brown,anthony86@gmail.com,263.280.6619x67862,,Frederick Shepard,2993 Diana Parks Apt. 103,,Denton,TX,76201,United States,US,1/21/20,,United States,US,TX,Denton,Google search,www.google.com/
367,1/16/20 3:50pm,Bandcamp,album,Music from Saharan WhatsApp,Etran de L'Aïr,USD,3.0,1.0,,3.0,,,,0.2,credit card,3.0,0.0,2876614577,,0.3,0.3,0.0,2.5,664.5,2.5,digital download,,http://etrandelair.bandcamp.com/album/music-from-saharan-whatsapp,,WHATSAPP-01,,,Molly Garcia,kelly17@yahoo.com,+1-323-032-9511x21569,,Kara Wallace,5198 Joe Cape,,,,,,,,,United States,US,NY,New York,Publish notice sent to your fans,
368,1/16/20 3:54pm,Bandcamp,album,Music from Saharan WhatsApp,Etran de L'Aïr,USD,3.0,1.0,,3.0,,,,0.2,paypal,3.0,0.0,280262120,,0.3,0.3,0.0,2.5,667.0,2.5,digital download,,http://etrandelair.bandcamp.com/album/music-from-saharan-whatsapp,,WHATSAPP-01,,,Marcus Barnes,oromero@gmail.com,787.766.3637x307,,Caitlin Pollard,560 Carlson Court,,,,,,,,,United States,US,NY,New York,Publish notice sent to your fans,
369,1/16/20 4:59pm,Bandcamp,album,Torodi,Hama,USD,7.0,1.0,,7.0,,,,0.4,credit card,7.0,0.0,1703748265,,0.7,0.7,0.0,5.9,672.9,5.9,digital download,,http://hamasynth.bandcamp.com/album/torodi,,SS-025,889326 664833,,Mark Ward,ashleywhite@greene.net,093.816.5936x8054,,George Bowen,0860 Valerie Heights Suite 101,,,,,,,,,United States,US,CA,El Sobrante,Bandcamp Daily (embedded player): hama-feature,daily.bandcamp.com/2019/02/27/hama-feature/
370,1/16/20 5:00pm,Bandcamp,album,Ilana: The Creator,Mdou Moctar,USD,10.0,1.0,,10.0,,,,0.49,paypal,10.0,0.0,3573693267,,1.0,1.0,0.0,8.51,681.41,8.51,digital download,,http://mdoumoctar.bandcamp.com/album/ilana-the-creator,,SS-051,602318 136893,,Justin Soto,wflores@gmail.com,504-526-0111,Please never stop making music. Much love!,Joseph Salas,27290 Kimberly Passage Apt. 660,,,,,,,,,United States,US,NH,Nashua,Google search,www.google.com/
371,1/16/20 5:46pm,Bandcamp,album,Music from Saharan WhatsApp,Etran de L'Aïr,USD,5.0,1.0,,5.0,,,,0.3,paypal,5.0,0.0,3178052620,,0.5,0.5,0.0,4.2,685.61,4.2,digital download,,http://etrandelair.bandcamp.com/album/music-from-saharan-whatsapp,,WHATSAPP-01,,,Dana Garcia,millerkevin@hotmail.com,+1-702-103-2962x5587,,Adrienne Chen,04905 Harry Rapid Apt. 350,,,,,,,,,United States,US,NV,Las Vegas,Bandcamp release notification: music feed,http://blog.bandcamp.com/2014/01/30/bandcamp-app-now-with-music-feed/
372,1/16/20 6:02pm,shop@sahelsounds.com,payout,,,USD,,,,,,,,0.84,transfer,84.44,83.6,t251700966,8Y649532KB525224R,,,,-84.44,601.17,,,,,,,,,,,,,,,,,,,,,,,,,,,,
373,1/16/20 6:02pm,shop@sahelsounds.com,payout,,,USD,,,,,,,,1.59,transfer,159.39,157.8,t251700967,7RW259488D867841H,,,,-159.39,441.78,,,,,,,,,,,,,,,,,,,,,,,,,,,,
374,1/16/20 6:30pm,Bandcamp,album,Music from Saharan WhatsApp,Etran de L'Aïr,USD,1.5,1.0,,1.5,,,,0.14,credit card,1.5,0.0,3298645145,,0.15,0.15,0.0,1.21,442.99,1.21,digital download,,http://etrandelair.bandcamp.com/album/music-from-saharan-whatsapp,,WHATSAPP-01,,,Katherine Gordon,mdorsey@fuller.com,510-030-7074,,Jacqueline Spence,22518 Morton Cove,,,,,,,,,France,FR,Saône-et-Loire,Ciry-le-Noble,,
375,1/16/20 6:31pm,Bandcamp,album,Music from Saharan WhatsApp,Etran de L'Aïr,USD,2.0,1.0,,2.0,,,,0.17,paypal,2.0,0.0,1834729072,,0.2,0.2,0.0,1.63,444.62,1.63,digital download,,http://etrandelair.bandcamp.com/album/music-from-saharan-whatsapp,,WHATSAPP-01,,,Sabrina Oconnell,amanda99@gmail.com,+1-910-802-3945x402,,Beverly Miller,852 Moore Extensions,,,,,,,,,United Kingdom,GB,England,London,Bandcamp search,bandcamp.com/app/android/search
376,1/16/20 6:49pm,Bandcamp,album,Sahel Sounds Label Sampler,Various Artists,USD,2.0,1.0,,2.0,,,,0.17,paypal,2.0,0.0,1786895883,,0.2,0.2,0.0,1.63,446.25,1.63,digital download,,http://sahelsounds.bandcamp.com/album/sahel-sounds-label-sampler,,SS-058,602318 137111,,Sean Love,whiteandre@tate-hunt.org,+1-052-783-5437x87466,,Jennifer Thompson,11991 Wright Ranch,,,,,,,,,Ireland,IE,Leinster,Dublin,Google search,www.google.com/
377,1/16/20 6:50pm,Bandcamp,album,Ilana: The Creator,Mdou Moctar,USD,10.0,1.0,,10.0,,,,0.49,paypal,10.0,0.0,1178440666,,1.0,1.0,0.0,8.51,454.76,8.51,digital download,,http://mdoumoctar.bandcamp.com/album/ilana-the-creator,,SS-051,602318 136893,,Brandi Lang,joseph88@page.com,069-766-0791x2875,,Suzanne Perez,470 Rose Mountain Suite 566,,,,,,,,,United States,US,GA,Savannah,Publish notice sent to your fans,
378,1/16/20 6:52pm,Bandcamp,album,Field Recordings from the Sahel,Sahel Sounds,USD,2.0,1.0,,2.0,,,,0.17,paypal,2.0,0.0,1183177565,,0.2,0.2,0.0,1.63,456.39,1.63,digital download,,http://sahelsounds.bandcamp.com/album/field-recordings-from-the-sahel,,SS-057,602318 137104,,Lori Romero,krhodes@brennan.info,714.023.7516x708,,Daniel Orr,52809 Allen Gardens Apt. 379,,,,,,,,,Ireland,IE,Leinster,Dublin,Bandcamp fan page: roostercogburn,bandcamp.com/roostercogburn
379,1/16/20 7:07pm,Bandcamp,album,Music from Saharan WhatsApp,Etran de L'Aïr,USD,1.5,1.0,,1.5,,,,0.13,paypal,1.5,0.0,3144595767,,0.15,0.15,0.0,1.22,457.61,1.22,digital download,,http://etrandelair.bandcamp.com/album/music-from-saharan-whatsapp,,WHATSAPP-01,,,Julie Odonnell,nathan13@price.com,817.700.4889,,Jason Campbell,077 John Forges,,,,,,,,,United States,US,CO,Delta,Bandcamp app discover,bandcamp.com/app/android/discover
380,1/16/20 7:13pm,Bandcamp,album,Music from Saharan WhatsApp,Etran de L'Aïr,USD,1.0,1.0,,1.0,,,,0.1,credit card,1.0,0.0,2935362417,,0.1,0.1,0.0,0.8,458.41,0.8,digital download,,http://etrandelair.bandcamp.com/album/music-from-saharan-whatsapp,,WHATSAPP-01,,,David Juarez,dickersondonna@hotmail.com,399-838-4898x096,,Haley Ball,44008 Waters Burgs,,,,,,,,,United States,US,NH,Portsmouth,Bandcamp fan wishlist,bandcamp.com/chip11under
381,1/16/20 7:17pm,Bandcamp,album,Music from Saharan WhatsApp,Etran de L'Aïr,USD,1.0,1.0,,1.0,,,,0.11,paypal,1.0,0.0,3956159328,,0.1,0.1,0.0,0.79,459.2,0.79,digital download,,http://etrandelair.bandcamp.com/album/music-from-saharan-whatsapp,,WHATSAPP-01,,,Jacob Howell,adrianmoody@gmail.com,370-688-4885,,William Gibson,59076 Kathleen Lights Suite 293,,,,,,,,,United Kingdom,GB,Bristol,Bristol,Google search,www.google.com/
382,1/16/20 7:26pm,Bandcamp,album,Sahel Sounds Label Sampler,Various Artists,USD,5.0,1.0,,5.0,,,,0.3,paypal,5.0,0.0,2314848367,,0.5,0.5,0.0,4.2,463.4,4.2,digital download,,http://sahelsounds.bandcamp.com/album/sahel-sounds-label-sampler,,SS-058,602318 137111,,Jennifer Mosley,dowens@anderson.info,858.772.7785x244,,James Zimmerman,3965 Kyle Plains,,,,,,,,,United States,US,PA,Blue Bell,,
383,1/16/20 7:39pm,Bandcamp,album,Sahel Sounds Label Sampler,Various Artists,USD,1.0,1.0,,1.0,,,,0.45,paypal,1.0,0.0,1654683491,,0.1,0.0,0.1,0.0,463.4,0.45,digital download,,http://sahelsounds.bandcamp.com/album/sahel-sounds-label-sampler,,SS-058,602318 137111,,Anna Atkins,harrywalters@hotmail.com,(462)651-1106,,Brandy Smith,0173 Bailey Valley Apt. 401,,,,,,,,,United States,US,CA,Santa Cruz,,
384,1/16/20 7:39pm,Bandcamp,album,Eghass Malan,Les Filles de Illighadad,USD,7.0,1.0,,7.0,,,,,,7.0,0.0,1654683491,,0.7,0.8,0.0,6.75,470.15,6.3,digital download,,http://lesfillesdeillighadad.bandcamp.com/album/eghass-malan,,SS-044,191515 928351,,David Molina,mccoymelissa@yahoo.com,839.903.9313x714,,Scott Stuart,273 Christina Fall Apt. 599,,,,,,,,,United States,US,CA,Santa Cruz,,
385,1/16/20 8:32pm,Bandcamp,package,Sahel Sounds Label Sampler,Various Artists,USD,20.0,1.0,,20.0,,5.0,United States,0.78,paypal,25.0,0.0,2830367066,,2.0,2.0,0.0,22.22,492.37,17.22,Sahel Sounds t-shirt,Medium,http://sahelsounds.bandcamp.com/merch/sahel-sounds-t-shirt,SS-T01-BLK-UMD,,,,Corey Norris,jamesbennett@yahoo.com,(711)783-5855,,Katie Saunders,17543 Torres Inlet Suite 329,,Milwaukee,WI,53207,United States,US,1/21/20,,United States,US,WI,Milwaukee,Google search,www.google.com/
386,1/16/20 8:48pm,Bandcamp,album,Music from Saharan WhatsApp,Etran de L'Aïr,USD,5.0,1.0,,5.0,,,,0.35,paypal,5.0,0.0,1819620676,,0.5,0.5,0.0,4.15,496.52,4.15,digital download,,http://etrandelair.bandcamp.com/album/music-from-saharan-whatsapp,,WHATSAPP-01,,,Vanessa Maddox,kelli37@yahoo.com,001-309-015-5308x787,,Tina White,156 Noble Spring,,,,,,,,,Germany,DE,Land Berlin,Berlin,Bandcamp artist: sahelsounds,sahelsounds.bandcamp.com/album/music-from-saharan-cellphones
387,1/16/20 8:59pm,Bandcamp,album,Music from Saharan WhatsApp,Etran de L'Aïr,USD,5.0,1.0,,5.0,,,,0.3,paypal,5.0,0.0,3444028556,,0.5,0.5,0.0,4.2,500.72,4.2,digital download,,http://etrandelair.bandcamp.com/album/music-from-saharan-whatsapp,,WHATSAPP-01,,,Terri Juarez,bretthensley@gmail.com,(573)084-1753x5907,,Susan Burnett,3093 Laura Camp Suite 435,,,,,,,,,United States,US,NJ,Hillsborough,Bandcamp fan wishlist,bandcamp.com/dpk
388,1/16/20 9:16pm,Bandcamp,album,Music from Saharan WhatsApp,Etran de L'Aïr,USD,1.0,1.0,,1.0,,,,0.11,paypal,1.0,0.0,106035770,,0.1,0.1,0.0,0.79,501.51,0.79,digital download,,http://etrandelair.bandcamp.com/album/music-from-saharan-whatsapp,,WHATSAPP-01,,,Thomas Patterson,xsavage@hotmail.com,001-623-098-0459x3171,,Alicia Olson,3870 Jennifer Locks Suite 835,,,,,,,,,Netherlands,NL,South Holland,Rijswijk,Google search,www.google.com/
389,1/16/20 10:06pm,Bandcamp,album,Music from Saharan WhatsApp,Etran de L'Aïr,USD,1.0,1.0,,1.0,,,,0.11,paypal,1.0,0.0,3791076811,,0.1,0.1,0.0,0.79,502.3,0.79,digital download,,http://etrandelair.bandcamp.com/album/music-from-saharan-whatsapp,,WHATSAPP-01,,,Kevin Brooks,schultzsabrina@hotmail.com,+1-572-991-8883x78295,,James Hartman,59701 Young Extensions,,,,,,,,,United Kingdom,GB,Stockport,Stockport,,
390,1/16/20 10:28pm,Bandcamp,album,Music from Saharan WhatsApp,Etran de L'Aïr,USD,1.0,1.0,,1.0,,,,0.1,paypal,1.0,0.0,1710459860,,0.1,0.1,0.0,0.8,503.1,0.8,digital download,,http://etrandelair.bandcamp.com/album/music-from-saharan-whatsapp,,WHATSAPP-01,,,Robert Poole,denisesmith@harrison.com,+1-289-416-7911x618,,Leslie Spencer,557 Vasquez Mountains Suite 673,,,,,,,,,United States,US,DC,Washington,Bandcamp release notification: music feed,http://blog.bandcamp.com/2013/09/19/strap-on-your-feed-bag/
391,1/16/20 10:56pm,Bandcamp,album,Music from Saharan WhatsApp,Etran de L'Aïr,USD,12.0,1.0,,12.0,,,,0.65,paypal,12.0,0.0,1367701192,,1.2,1.2,0.0,10.15,513.25,10.15,digital download,,http://etrandelair.bandcamp.com/album/music-from-saharan-whatsapp,,WHATSAPP-01,,,Jacob Duran,kgarrison@floyd.com,001-036-883-1888,,Jay Ortiz,43016 Cole Trafficway Suite 534,,,,,,,,,Spain,ES,Valencia,Valencia,Facebook,www.facebook.com
392,1/16/20 10:58pm,Bandcamp,album,Music from Saharan Cellphones,Various,USD,7.0,1.0,,7.0,,,,0.57,paypal,7.0,0.0,330935004,,0.7,0.0,0.7,0.0,513.25,5.73,digital download,,http://sahelsounds.bandcamp.com/album/music-from-saharan-cellphones,,SS-003,889326 667889,,Albert Evans,emily38@clark.com,8065850513,,Jennifer Armstrong,50331 Deanna Rest,,,,,,,,,United States,US,LA,Cut Off,Bandcamp artist: sahelsounds,sahelsounds.bandcamp.com
393,1/16/20 10:58pm,Bandcamp,album,Music from Saharan Cellphones: Volume 2,Various,USD,7.0,1.0,,7.0,,,,,,7.0,0.0,330935004,,0.7,1.4,0.0,12.03,525.28,6.3,digital download,,http://sahelsounds.bandcamp.com/album/music-from-saharan-cellphones-volume-2,,SS-012,889326 667742,,Kelly Allen,joshuataylor@taylor.org,5043447107,,Daniel Grimes,582 Louis Haven Apt. 474,,,,,,,,,United States,US,LA,Cut Off,Bandcamp artist: sahelsounds,sahelsounds.bandcamp.com
394,1/16/20 11:32pm,Bandcamp,album,Issawat,Idassane Wallet Mohamed,USD,7.0,1.0,,7.0,,,,1.92,paypal,7.0,0.0,3697960482,,0.7,0.0,0.7,0.0,525.28,4.38,digital download,,http://idassanewalletmohamed.bandcamp.com/album/issawat,,SS-015,889326 667766,,Terri Norris,richardhall@romero.com,666-182-4914,,David Martin,938 Jarvis Well,,,,,,,,,Australia,AU,VIC,Surrey Hills,,
395,1/16/20 11:32pm,Bandcamp,album,Torodi,Hama,USD,7.0,1.0,,7.0,,,,,,7.0,0.0,3697960482,,0.7,0.0,1.4,0.0,525.28,6.3,digital download,,http://hamasynth.bandcamp.com/album/torodi,,SS-025,889326 664833,,James Horton,whitakerallison@hotmail.com,664.938.1127x269,,Melissa Ross,4944 Heather Crossing Suite 430,,,,,,,,,Australia,AU,VIC,Surrey Hills,,
396,1/16/20 11:32pm,Bandcamp,album,Waande Kadde,Amadou Binta Konté and Tidiane Thiam,USD,7.0,1.0,,7.0,,,,,,7.0,0.0,3697960482,,0.7,0.0,2.1,0.0,525.28,6.3,digital download,,http://sahelsounds.bandcamp.com/album/waande-kadde,,SS-036 / SFH-01,889326 796008,,Linda Wright,rtravis@gmail.com,(484)198-5267x66243,,Kenneth Smith,856 Teresa Ports Apt. 361,,,,,,,,,Australia,AU,VIC,Surrey Hills,,
397,1/16/20 11:32pm,Bandcamp,album,Agrim Agadez,Various,USD,7.0,1.0,,7.0,,,,,,7.0,0.0,3697960482,,0.7,0.0,2.8,0.0,525.28,6.3,digital download,,http://sahelsounds.bandcamp.com/album/agrim-agadez,,SS-038,889326 872382,,Kelly Campbell,allenmann@hotmail.com,(459)676-7415x512,,Brooke Chavez,6944 Reynolds Gateway,,,,,,,,,Australia,AU,VIC,Surrey Hills,,
398,1/16/20 11:32pm,Bandcamp,album,Sahel Sounds Label Sampler,Various Artists,USD,7.0,1.0,,7.0,,,,,,7.0,0.0,3697960482,,0.7,0.0,3.5,0.0,525.28,6.3,digital download,,http://sahelsounds.bandcamp.com/album/sahel-sounds-label-sampler,,SS-058,602318 137111,,Ashley Mcdonald,ffischer@woodard.info,6081828312,,Kayla Reed,19788 Steele Ports,,,,,,,,,Australia,AU,VIC,Surrey Hills,,
399,1/16/20 11:32pm,Bandcamp,album,Les Filles de Illighadad,Les Filles de Illighadad,USD,7.0,1.0,,7.0,,,,,,7.0,0.0,3697960482,,0.7,0.0,4.2,0.0,525.28,6.3,digital download,,http://lesfillesdeillighadad.bandcamp.com/album/les-filles-de-illighadad,,SS-033,889326 664918,,Shawn Goodman,thomasbriana@hotmail.com,025.371.3204,,Jessica Li,7979 Rhonda Oval Suite 560,,,,,,,,,Australia,AU,VIC,Surrey Hills,,
400,1/16/20 11:32pm,Bandcamp,album,Eghass Malan,Les Filles de Illighadad,USD,7.0,1.0,,7.0,,,,,,7.0,0.0,3697960482,,0.7,0.0,4.9,0.0,525.28,6.3,digital download,,http://lesfillesdeillighadad.bandcamp.com/album/eghass-malan,,SS-044,191515 928351,,Mike Steele,cardenasjessica@pena-wood.net,850.137.3185,,Samuel Craig,37796 Kathy Meadow,,,,,,,,,Australia,AU,VIC,Surrey Hills,,
401,1/16/20 11:32pm,Bandcamp,album,Isswat,Fadimoutou Wallet Inamoud,USD,7.0,1.0,,7.0,,,,,,7.0,0.0,3697960482,,0.7,5.6,0.0,48.48,573.76,6.3,digital download,,http://fadimoutouwalletinamoud.bandcamp.com/album/isswat,,SS-026,889326 667872,,Patricia Lee,ryanharris@bush.com,740-169-8052x23414,,Brenda Robinson,94842 Amanda Trace Suite 565,,,,,,,,,Australia,AU,VIC,Surrey Hills,,
402,1/16/20 11:40pm,Bandcamp,album,Les Filles de Illighadad,Les Filles de Illighadad,USD,10.0,1.0,,10.0,,,,0.52,credit card,10.0,0.0,839052531,,1.0,1.0,0.0,8.48,582.24,8.48,digital download,,http://lesfillesdeillighadad.bandcamp.com/album/les-filles-de-illighadad,,SS-033,889326 664918,,Sarah Brown,crawfordshaun@yahoo.com,001-302-659-1409,,Christian Mccarthy,77602 Jacob Estates Suite 824,,,,,,,,,United States,US,WA,Seattle,Google search,www.google.com/
403,1/17/20 12:39am,Bandcamp,album,Music from Saharan WhatsApp,Etran de L'Aïr,USD,5.0,1.0,,5.0,,,,0.3,paypal,5.0,0.0,4140604239,,0.5,0.5,0.0,4.2,586.44,4.2,digital download,,http://etrandelair.bandcamp.com/album/music-from-saharan-whatsapp,,WHATSAPP-01,,,Juan Johnston,danielleevans@crawford-scott.biz,001-088-311-7240,,Debra Wright,00732 Jones Terrace,,,,,,,,,United States,US,FL,Orlando,,
404,1/17/20 1:04am,Bandcamp,album,Music from Saharan WhatsApp,Etran de L'Aïr,USD,4.0,1.0,,4.0,,,,0.25,paypal,4.0,0.0,683407634,,0.4,0.4,0.0,3.35,589.79,3.35,digital download,,http://etrandelair.bandcamp.com/album/music-from-saharan-whatsapp,,WHATSAPP-01,,,Wayne Burns,vjackson@yahoo.com,+1-119-646-9616x8510,,Kenneth Rodriguez,5639 Hayden Stravenue Suite 839,,,,,,,,,United States,US,MD,Catonsville,Bandcamp fan wishlist,bandcamp.com/jeffstein
405,1/17/20 2:02am,Bandcamp,album,Music from Saharan WhatsApp,Etran de L'Aïr,USD,1.0,1.0,,1.0,,,,0.11,credit card,1.0,0.0,2192831018,,0.1,0.1,0.0,0.79,590.58,0.79,digital download,,http://etrandelair.bandcamp.com/album/music-from-saharan-whatsapp,,WHATSAPP-01,,,Taylor Hudson,dustindavenport@parker.com,+1-797-040-7949x91158,,Dean Salazar,82834 Samantha Center,,,,,,,,,Japan,JP,Tokyo,Shinjuku,Bandcamp New & Notable,bandcamp.com/#new-notable
406,1/17/20 2:05am,Bandcamp,album,Music from Saharan WhatsApp,Etran de L'Aïr,USD,3.0,1.0,,3.0,,,,0.2,credit card,3.0,0.0,1225830613,,0.3,0.3,0.0,2.5,593.08,2.5,digital download,,http://etrandelair.bandcamp.com/album/music-from-saharan-whatsapp,,WHATSAPP-01,,,Corey Smith,brittanyreed@gmail.com,+1-339-226-5838,,Sarah Green,0090 Russell Lane Suite 538,,,,,,,,,United States,US,OR,Portland,,
407,1/17/20 2:20am,Bandcamp,album,Music from Saharan WhatsApp,Etran de L'Aïr,USD,5.0,1.0,,5.0,,,,0.35,paypal,5.0,0.0,2710326493,,0.5,0.5,0.0,4.15,597.23,4.15,digital download,,http://etrandelair.bandcamp.com/album/music-from-saharan-whatsapp,,WHATSAPP-01,,,Sydney Gomez,elaineboone@turner-ramos.com,001-284-089-4370x2653,,Erin Scott,534 Romero Rest Apt. 722,,,,,,,,,Canada,CA,BC,Langley,Google search,www.google.ca/
408,1/17/20 2:27am,Bandcamp,album,Music from Saharan WhatsApp,Etran de L'Aïr,USD,3.0,1.0,,3.0,,,,0.23,paypal,3.0,0.0,4034091047,,0.3,0.3,0.0,2.47,599.7,2.47,digital download,,http://etrandelair.bandcamp.com/album/music-from-saharan-whatsapp,,WHATSAPP-01,,,Amber Scott,scott11@harris.com,992-268-2347x496,,Steven Reynolds,85370 Tucker Causeway,,,,,,,,,Canada,CA,MB,Winnipeg,Publish notice sent to your fans,
409,1/17/20 2:36am,Bandcamp,album,Music from Saharan WhatsApp,Etran de L'Aïr,USD,9.99,1.0,,9.99,,,,0.49,paypal,9.99,0.0,2961941659,,1.0,1.0,0.0,8.5,608.2,8.5,digital download,,http://etrandelair.bandcamp.com/album/music-from-saharan-whatsapp,,WHATSAPP-01,,,David Wagner,timothyreyes@yahoo.com,+1-651-854-6327x3020,,Ellen Thomas,67259 Daniel Underpass Apt. 881,,,,,,,,,United States,US,RI,Providence,,
410,1/17/20 2:44am,Bandcamp,album,Music from Saharan WhatsApp,Etran de L'Aïr,USD,10.0,1.0,,10.0,,,,0.49,paypal,10.0,0.0,537934665,,1.0,1.0,0.0,8.51,616.71,8.51,digital download,,http://etrandelair.bandcamp.com/album/music-from-saharan-whatsapp,,WHATSAPP-01,,,Janet Gates,fanderson@hicks.com,(894)795-3642x657,,Jennifer Watson,004 Brown Passage Apt. 514,,,,,,,,,United States,US,AZ,Glendale,Google search,www.google.com/
411,1/17/20 3:04am,Bandcamp,album,Ilana: The Creator,Mdou Moctar,USD,7.0,1.0,,7.0,,,,0.76,credit card,7.0,0.0,1044051321,,0.7,0.0,0.7,0.0,616.71,5.54,digital download,,http://mdoumoctar.bandcamp.com/album/ilana-the-creator,,SS-051,602318 136893,,Patricia Morgan,gregward@yahoo.com,001-150-834-8941,,Steven West,6622 Garcia Fields,,,,,,,,,United States,US,WI,Madison,,
412,1/17/20 3:04am,Bandcamp,album,Sousoume Tamachek,Mdou Moctar,USD,7.0,1.0,,7.0,,,,,,7.0,0.0,1044051321,,0.7,0.0,1.4,0.0,616.71,6.3,digital download,,http://mdoumoctar.bandcamp.com/album/sousoume-tamachek,,SS-043,191515 769435,,Stephanie Ballard,barbara02@jordan.info,001-787-214-4187x51533,,Maria Marsh,1761 Brown Expressway Suite 823,,,,,,,,,United States,US,WI,Madison,Bandcamp artist: mdoumoctar,mdoumoctar.bandcamp.com
413,1/17/20 3:04am,Bandcamp,album,Akounak Tedalat Taha Tazoughai OST,Mdou Moctar,USD,7.0,1.0,,7.0,,,,,,7.0,0.0,1044051321,,0.7,2.1,0.0,18.14,634.85,6.3,digital download,,http://mdoumoctar.bandcamp.com/album/akounak-tedalat-taha-tazoughai-ost,,SS-028,889326 667599,,Bruce King,iwilliams@gmail.com,(500)765-8109x14574,,Tony Kelly,431 Nichols Knoll Suite 559,,,,,,,,,United States,US,WI,Madison,Bandcamp artist: mdoumoctar,mdoumoctar.bandcamp.com
414,1/17/20 3:41am,Bandcamp,package,Ilana: The Creator,Mdou Moctar,USD,17.0,1.0,,17.0,,5.0,United States,0.94,gift card,22.0,0.0,3768036978,,1.7,1.7,0.0,19.36,654.21,14.36,Ilana LP,,http://mdoumoctar.bandcamp.com/album/ilana-the-creator,SS-051lp,SS-051,602318 136893,,Stephanie Murray,michaelkeller@valdez-mcdaniel.com,760.938.8812x820,,Walter Watkins,2032 Tony Path Apt. 177,,Chicago,IL,60640,United States,US,1/21/20,,United States,US,IL,Chicago,Bandcamp fan wishlist,bandcamp.com/davewillpark
415,1/17/20 3:47am,Bandcamp,album,Music from Saharan WhatsApp,Etran de L'Aïr,USD,1.0,1.0,,1.0,,,,0.11,paypal,1.0,0.0,2561485287,,0.1,0.1,0.0,0.79,655.0,0.79,digital download,,http://etrandelair.bandcamp.com/album/music-from-saharan-whatsapp,,WHATSAPP-01,,,Jamie Gomez,burnettdiana@allison.com,3095463133,,Andrea Smith,580 Torres Falls,,,,,,,,,Australia,AU,VIC,Hawthorn,,
416,1/17/20 5:38am,Bandcamp,album,Sahel Sounds Label Sampler,Various Artists,USD,1.0,1.0,,1.0,,,,0.1,paypal,1.0,0.0,3489919150,,0.1,0.1,0.0,0.8,655.8,0.8,digital download,,http://sahelsounds.bandcamp.com/album/sahel-sounds-label-sampler,,SS-058,602318 137111,,Jerry Craig,sarahstone@hotmail.com,155-488-8030x50762,,Christopher Stein,3344 Casey Spring,,,,,,,,,United States,US,CO,Delta,Bandcamp app fan collection: jewelley,bandcamp.com/jewelley
417,1/17/20 6:16am,Bandcamp,album,Music from Saharan WhatsApp,Etran de L'Aïr,USD,5.0,1.0,,5.0,,,,0.3,paypal,5.0,0.0,4192244902,,0.5,0.5,0.0,4.2,660.0,4.2,digital download,,http://etrandelair.bandcamp.com/album/music-from-saharan-whatsapp,,WHATSAPP-01,,,Ashley Thompson,christianosborn@hunter.org,001-352-442-4279x5863,,Anthony Roth,609 Alec Isle Suite 383,,,,,,,,,United States,US,CA,San Mateo,Google search,www.google.com/
418,1/17/20 6:39am,Bandcamp,album,Music from Saharan Cellphones,Various,USD,8.0,1.0,,8.0,1.33,,,0.57,paypal,9.33,0.0,4092740379,,0.8,0.8,0.0,6.63,666.63,6.63,digital download,,http://sahelsounds.bandcamp.com/album/music-from-saharan-cellphones,,SS-003,889326 667889,,Heidi Gray,jacksonjohn@warren.com,(043)050-3683,,Jeffrey Ford,00129 Tracy Parks,,,,,,,,,Germany,DE,Mecklenburg-Vorpommern,Rostock,,
419,1/17/20 6:42am,Bandcamp,album,Music from Saharan WhatsApp,Etran de L'Aïr,USD,5.0,1.0,,5.0,,,,0.3,paypal,5.0,0.0,1437771638,,0.5,0.5,0.0,4.2,670.83,4.2,digital download,,http://etrandelair.bandcamp.com/album/music-from-saharan-whatsapp,,WHATSAPP-01,,,Craig Young,steven10@gmail.com,(068)401-8782x49955,,Daryl Carlson,83315 Albert Oval Apt. 975,,,,,,,,,United States,US,WA,Tacoma,Bandcamp fan wishlist,bandcamp.com/isaacolson
420,1/17/20 6:57am,Bandcamp,album,Music from Saharan WhatsApp,Etran de L'Aïr,USD,1.0,1.0,,1.0,,,,0.1,paypal,1.0,0.0,2026933028,,0.1,0.1,0.0,0.8,671.63,0.8,digital download,,http://etrandelair.bandcamp.com/album/music-from-saharan-whatsapp,,WHATSAPP-01,,,Stephanie Miller,william48@yahoo.com,+1-584-343-8489x425,,Karen Dixon,316 Hill Ville Suite 222,,,,,,,,,United States,US,CA,Menlo Park,Publish notice sent to your fans,
421,1/17/20 10:36am,Bandcamp,package,Les Filles de Illighadad,Les Filles de Illighadad,USD,20.0,1.0,,20.0,,5.0,United States,0.78,paypal,25.0,0.0,749035308,,2.0,2.0,0.0,22.22,693.85,17.22,Les Filles de Illighadad LP,,http://lesfillesdeillighadad.bandcamp.com/album/les-filles-de-illighadad,SS-033-LP,SS-033,889326 664918,,Anthony Smith,meyerdaniel@gmail.com,+1-496-297-8824,"Thank you! Gardo Ramirez Alhambra, California",Brian Chen,14596 Wells Mountains,,Alhambra,CA,91801,United States,US,1/21/20,,United States,US,CA,Alhambra,,
422,1/17/20 10:39am,Bandcamp,package,Eghass Malan,Les Filles de Illighadad,USD,20.0,1.0,,20.0,,5.0,United States,0.78,paypal,25.0,0.0,1277697875,,2.0,2.0,0.0,22.22,716.07,17.22,'Eghass Malan' LP,,http://lesfillesdeillighadad.bandcamp.com/album/eghass-malan,SS-044lp-1,SS-044,191515 928351,,Patrick Lindsey,ryanelizabeth@sherman-hamilton.info,(810)368-1850x9223,,Alexis Duncan,891 Yang Islands Apt. 933,,Alhambra,CA,91801,United States,US,1/21/20,,United States,US,CA,Alhambra,bandcamp.com,bandcamp.com
423,1/17/20 12:45pm,Bandcamp,album,Music from Saharan WhatsApp,Etran de L'Aïr,USD,5.0,1.0,,5.0,,,,0.35,paypal,5.0,0.0,3043147823,,0.5,0.5,0.0,4.15,720.22,4.15,digital download,,http://etrandelair.bandcamp.com/album/music-from-saharan-whatsapp,,WHATSAPP-01,,,Jason Cox,lisa58@yahoo.com,(438)304-8844x6753,,Paul Campbell,874 Sarah Fort Apt. 164,,,,,,,,,United Kingdom,GB,Southwark,Dulwich,Facebook,www.facebook.com
424,1/17/20 12:57pm,Bandcamp,album,Eghass Malan,Les Filles de Illighadad,USD,7.0,1.0,,7.0,1.61,,,0.55,paypal,8.61,0.0,1100926667,,0.7,0.7,0.0,5.75,725.97,5.75,digital download,,http://lesfillesdeillighadad.bandcamp.com/album/eghass-malan,,SS-044,191515 928351,,Jane Moore,weberrhonda@yahoo.com,(710)417-8445x3335,,Caroline Ramirez,9241 Ruiz Court,,,,,,,,,Portugal,PT,Lisbon,Lisbon,Google search,www.google.com/
425,1/17/20 2:30pm,Bandcamp,album,Music from Saharan WhatsApp,Etran de L'Aïr,USD,5.0,1.0,,5.0,,,,0.3,credit card,5.0,0.0,3154350083,,0.5,0.5,0.0,4.2,730.17,4.2,digital download,,http://etrandelair.bandcamp.com/album/music-from-saharan-whatsapp,,WHATSAPP-01,,,Shannon Higgins,rconner@hotmail.com,+1-217-130-7560x326,,Brittany Webb,3208 Sanford Skyway Apt. 826,,,,,,,,,United States,US,NJ,Princeton,Bandcamp search,bandcamp.com/app/android/search
426,1/17/20 2:44pm,Bandcamp,package,Ilana: The Creator,Mdou Moctar,USD,17.0,1.0,,17.0,,5.0,United States,0.72,paypal,22.0,0.0,798254954,,1.7,1.7,0.0,19.58,749.75,14.58,Ilana LP,,http://mdoumoctar.bandcamp.com/album/ilana-the-creator,SS-051lp,SS-051,602318 136893,,Keith Mitchell,harrissarah@hotmail.com,967.894.9330,,Julian Bowman,365 Jennifer Junctions,,Harrisville,UT,84414,United States,US,1/21/20,,United States,US,UT,Harrisville,Bandcamp search,bandcamp.com/app/android/search
427,1/17/20 3:13pm,Bandcamp,package,Eghass Malan,Les Filles de Illighadad,USD,17.0,1.0,,17.0,,5.0,United States,0.72,paypal,22.0,0.0,1657310320,,1.7,1.7,0.0,19.58,769.33,14.58,'Eghass Malan' LP,,http://lesfillesdeillighadad.bandcamp.com/album/eghass-malan,SS-044lp-1,SS-044,191515 928351,,Jay Forbes,donnawiley@pittman.com,+1-308-155-4923x14689,,Ashley Harding,1361 Owens Rapid,,Ambler,PA,19002,United States,US,1/21/20,,United States,US,PA,Ambler,,
428,1/17/20 3:46pm,Bandcamp,album,Eghass Malan,Les Filles de Illighadad,USD,7.0,1.0,,7.0,,,,0.4,credit card,7.0,0.0,1917799165,,0.7,0.7,0.0,5.9,775.23,5.9,digital download,,http://lesfillesdeillighadad.bandcamp.com/album/eghass-malan,,SS-044,191515 928351,,Stephen Lawson,cbrown@malone-johnson.com,313.513.0594x1558,,Luis Myers,442 Young Prairie,,,,,,,,,United States,US,VT,Pawlet,Bandcamp artist recommendation: mrairplaneman,bandcamp.com/recommended/mrairplaneman
429,1/17/20 3:49pm,Bandcamp,album,Music from Saharan WhatsApp,Etran de L'Aïr,USD,2.0,1.0,,2.0,,,,0.17,paypal,2.0,0.0,1246595383,,0.2,0.2,0.0,1.63,776.86,1.63,digital download,,http://etrandelair.bandcamp.com/album/music-from-saharan-whatsapp,,WHATSAPP-01,,,Matthew Bradley,alisonayala@hotmail.com,001-684-450-8324x0900,,David Carson,15699 James Skyway,,,,,,,,,United Kingdom,GB,,,Bandcamp release notification: music feed,http://blog.bandcamp.com/2014/01/30/bandcamp-app-now-with-music-feed/
430,1/17/20 3:57pm,Bandcamp,album,Music from Saharan WhatsApp,Etran de L'Aïr,USD,5.0,1.0,,5.0,,,,0.3,paypal,5.0,0.0,3930118926,,0.5,0.5,0.0,4.2,781.06,4.2,digital download,,http://etrandelair.bandcamp.com/album/music-from-saharan-whatsapp,,WHATSAPP-01,,,Robert Hoffman,smorales@williams.com,323.407.5522x4347,,Adam Love,8896 Lopez Square Suite 764,,,,,,,,,United States,US,CA,Los Angeles,Bandcamp fan activity email,bandcamp.com
431,1/17/20 4:05pm,Bandcamp,album,Music from Saharan WhatsApp,Etran de L'Aïr,USD,5.0,1.0,,5.0,,,,0.35,paypal,5.0,0.0,306587903,,0.5,0.5,0.0,4.15,785.21,4.15,digital download,,http://etrandelair.bandcamp.com/album/music-from-saharan-whatsapp,,WHATSAPP-01,,,Cameron Green,marie78@carr.biz,387-877-3012,,Rhonda Munoz,3124 George Light,,,,,,,,,United Kingdom,GB,Manchester,Manchester,Bandcamp New & Notable,bandcamp.com/#new-notable
432,1/17/20 4:27pm,Bandcamp,album,Music from Saharan WhatsApp,Etran de L'Aïr,USD,4.0,1.0,,4.0,,,,0.25,credit card,4.0,0.0,929327446,,0.4,0.4,0.0,3.35,788.56,3.35,digital download,,http://etrandelair.bandcamp.com/album/music-from-saharan-whatsapp,,WHATSAPP-01,,,Stephanie Wright,sandersdaniel@parsons.com,+1-564-765-5160x463,,Timothy Scott,11170 Crawford Springs Apt. 005,,,,,,,,,Greece,GR,Attica,Athens,Publish notice sent to your fans,
433,1/17/20 4:38pm,Bandcamp,album,Music from Saharan WhatsApp,Etran de L'Aïr,USD,3.0,1.0,,3.0,,,,0.23,paypal,3.0,0.0,2345787666,,0.3,0.3,0.0,2.47,791.03,2.47,digital download,,http://etrandelair.bandcamp.com/album/music-from-saharan-whatsapp,,WHATSAPP-01,,,Joshua Rogers,ddoyle@lee.info,275.496.6339,,Leonard Krueger,4902 Hall Estates,,,,,,,,,Canada,CA,BC,Vancouver,Bandcamp Discover,bandcamp.com/#discover
434,1/17/20 5:04pm,Bandcamp,album,Music from Saharan WhatsApp,Etran de L'Aïr,USD,3.0,1.0,,3.0,,,,0.2,paypal,3.0,0.0,3168255740,,0.3,0.3,0.0,2.5,793.53,2.5,digital download,,http://etrandelair.bandcamp.com/album/music-from-saharan-whatsapp,,WHATSAPP-01,,,Sara Smith,johnsmith@gmail.com,613.211.6117x35059,,Angela Williams,685 Thornton Lane,,,,,,,,,United States,US,NC,Charlotte,Bandcamp music feed,http://blog.bandcamp.com/2014/01/30/bandcamp-app-now-with-music-feed/
435,1/17/20 5:23pm,Bandcamp,album,Ilana: The Creator,Mdou Moctar,USD,7.0,1.0,,7.0,1.33,,,0.54,paypal,8.33,0.0,320701574,,0.7,0.7,0.0,5.76,799.29,5.76,digital download,,http://mdoumoctar.bandcamp.com/album/ilana-the-creator,,SS-051,602318 136893,,Chloe Shaw,mhernandez@fischer.info,(017)178-7074x170,,Madison Romero,3913 Green Lake Suite 210,,,,,,,,,Germany,DE,Hesse,Frankfurt am Main,Bandcamp: spacecowgirl/following/artists_and_labels,bandcamp.com/spacecowgirl/following/artists_and_labels
436,1/17/20 5:44pm,Bandcamp,album,Music from Saharan WhatsApp,Etran de L'Aïr,USD,10.0,1.0,,10.0,,,,0.49,paypal,10.0,0.0,424007569,,1.0,1.0,0.0,8.51,807.8,8.51,digital download,,http://etrandelair.bandcamp.com/album/music-from-saharan-whatsapp,,WHATSAPP-01,,,Wendy Harrison,afry@barajas.net,(779)053-5412x743,,Lauren Castro,22883 Jason Cliffs,,,,,,,,,United States,US,TX,Marfa,Google search,www.google.com/
437,1/17/20 6:02pm,shop@sahelsounds.com,payout,,,USD,,,,,,,,2.21,transfer,220.55,218.34,t251965977,3ER78854491565924,,,,-220.55,587.25,,,,,,,,,,,,,,,,,,,,,,,,,,,,
438,1/17/20 6:02pm,shop@sahelsounds.com,payout,,,USD,,,,,,,,2.21,transfer,221.23,219.02,t251965979,82P15529AV610773R,,,,-221.23,366.02,,,,,,,,,,,,,,,,,,,,,,,,,,,,
439,1/17/20 6:33pm,Bandcamp,album,Music from Saharan WhatsApp,Etran de L'Aïr,USD,5.0,1.0,,5.0,,,,0.35,credit card,5.0,0.0,2680944583,,0.5,0.5,0.0,4.15,370.17,4.15,digital download,,http://etrandelair.bandcamp.com/album/music-from-saharan-whatsapp,,WHATSAPP-01,,,Kevin Donovan,debbie49@snyder.com,001-310-127-8678x2460,,Darryl Andrade,9525 James Inlet Suite 232,,,,,,,,,United Kingdom,GB,Gateshead,Gateshead,Publish notice sent to your fans,
440,1/17/20 6:44pm,Bandcamp,album,Music from Saharan WhatsApp,Etran de L'Aïr,USD,1.0,1.0,,1.0,,,,0.11,credit card,1.0,0.0,1044997376,,0.1,0.1,0.0,0.79,370.96,0.79,digital download,,http://etrandelair.bandcamp.com/album/music-from-saharan-whatsapp,,WHATSAPP-01,,,Nancy Andrews,megan15@yahoo.com,(337)545-8872x88643,,Margaret Jensen,5583 Lauren Port Suite 144,,,,,,,,,United Kingdom,GB,,,Publish notice sent to your fans,
441,1/17/20 7:16pm,Bandcamp,album,Music from Saharan Cellphones,Various,USD,7.0,1.0,,7.0,,,,0.4,paypal,7.0,0.0,3986978175,,0.7,0.7,0.0,5.9,376.86,5.9,digital download,,http://sahelsounds.bandcamp.com/album/music-from-saharan-cellphones,,SS-003,889326 667889,,Ronald Williams,michele59@yahoo.com,253-651-9920x7824,,Jeremiah Baldwin,4579 King Field,,,,,,,,,United States,US,CA,San Francisco,tumblr.com,www.tumblr.com/
442,1/17/20 7:29pm,Bandcamp,album,Music from Saharan WhatsApp,Etran de L'Aïr,USD,8.0,1.0,,8.0,,,,0.45,paypal,8.0,0.0,754647008,,0.8,0.8,0.0,6.75,383.61,6.75,digital download,,http://etrandelair.bandcamp.com/album/music-from-saharan-whatsapp,,WHATSAPP-01,,,Tracy Wright,william51@hotmail.com,+1-345-821-1498x36693,,Timothy Nunez,5773 Weaver Key,,,,,,,,,United States,US,WI,Milwaukee,Google search,www.google.com/
443,1/17/20 8:01pm,Bandcamp,album,Music from Saharan WhatsApp,Etran de L'Aïr,USD,6.0,1.0,,6.0,,,,0.35,paypal,6.0,0.0,4213380022,,0.6,0.6,0.0,5.05,388.66,5.05,digital download,,http://etrandelair.bandcamp.com/album/music-from-saharan-whatsapp,,WHATSAPP-01,,,Susan Thompson,jennifermorrison@gmail.com,986.840.8355x3167,,Adrian Curry,3089 Alejandro View,,,,,,,,,United States,US,HI,Honolulu,Publish notice sent to your fans,
444,1/17/20 8:24pm,Bandcamp,package,Ilana: The Creator,Mdou Moctar,USD,17.0,1.0,,17.0,,5.0,United States,0.78,credit card,22.0,0.0,3574610853,,1.7,1.7,0.0,19.52,408.18,14.52,Ilana LP,,http://mdoumoctar.bandcamp.com/album/ilana-the-creator,SS-051lp,SS-051,602318 136893,,Grace Baker,thomas57@gmail.com,478.096.2683x877,,Manuel Patterson,072 Nunez Port Apt. 155,,Corvallis,OR,97333,United States,US,1/21/20,,United States,US,OR,Corvallis,,
445,1/17/20 9:08pm,Bandcamp,album,Music from Saharan WhatsApp,Etran de L'Aïr,USD,5.0,1.0,,5.0,,,,0.35,paypal,5.0,0.0,626258539,,0.5,0.5,0.0,4.15,412.33,4.15,digital download,,http://etrandelair.bandcamp.com/album/music-from-saharan-whatsapp,,WHATSAPP-01,,,Calvin Ellis,efoster@sanford.com,212.122.5846,,Haley Mclaughlin,97127 Cannon Loaf,,,,,,,,,United Kingdom,GB,Greenwich,Greenwich,,
446,1/17/20 9:25pm,Bandcamp,album,Music from Saharan WhatsApp,Etran de L'Aïr,USD,5.0,1.0,,5.0,,,,0.35,paypal,5.0,0.0,2281697599,,0.5,0.5,0.0,4.15,416.48,4.15,digital download,,http://etrandelair.bandcamp.com/album/music-from-saharan-whatsapp,,WHATSAPP-01,,,Diana Tran,stevenkramer@williams.net,001-121-467-4831x53878,,Barbara Hurley,20599 Green Spring,,,,,,,,,United Kingdom,GB,Glasgow City,Glasgow,l.instagram.com,l.instagram.com/
447,1/17/20 9:38pm,Bandcamp,album,Ilana: The Creator,Mdou Moctar,USD,10.0,1.0,,10.0,,,,0.62,credit card,10.0,0.0,3736281506,,1.0,1.0,0.0,8.38,424.86,8.38,digital download,,http://mdoumoctar.bandcamp.com/album/ilana-the-creator,,SS-051,602318 136893,,Eduardo Myers,pmendoza@cortez-wright.com,+1-926-274-9634x64608,,Jason Griffith,8517 Lee Road Suite 629,,,,,,,,,Jordan,JO,Amman Governorate,Amman,Google search,www.google.com/
448,1/17/20 9:44pm,Bandcamp,album,Music from Saharan WhatsApp,Etran de L'Aïr,USD,5.0,1.0,,5.0,,,,0.35,paypal,5.0,0.0,509389443,,0.5,0.5,0.0,4.15,429.01,4.15,digital download,,http://etrandelair.bandcamp.com/album/music-from-saharan-whatsapp,,WHATSAPP-01,,,Michele Stewart,vwilliams@scott-holmes.info,577.985.4665x566,,Melanie Silva,6809 Richard Lake,,,,,,,,,Australia,AU,NSW,Sydney,Bandcamp weekly newsletter,bandcamp.com
449,1/17/20 10:11pm,Bandcamp,album,Music from Saharan Cellphones,Various,USD,10.0,1.0,,10.0,,,,0.49,paypal,10.0,0.0,3667469978,,1.0,1.0,0.0,8.51,437.52,8.51,digital download,,http://sahelsounds.bandcamp.com/album/music-from-saharan-cellphones,,SS-003,889326 667889,,Richard Terrell,josephmorales@lopez.com,+1-530-711-6699x713,,Christopher Bray,087 Patrick Tunnel Apt. 342,,,,,,,,,United States,US,IA,Iowa City,t.umblr.com,t.umblr.com/
450,1/17/20 10:23pm,Bandcamp,album,Music from Saharan WhatsApp,Etran de L'Aïr,USD,3.0,1.0,,3.0,,,,0.23,paypal,3.0,0.0,524798700,,0.3,0.3,0.0,2.47,439.99,2.47,digital download,,http://etrandelair.bandcamp.com/album/music-from-saharan-whatsapp,,WHATSAPP-01,,,Brenda Allen,figueroajim@franklin-gross.com,3864590473,,Bryan Simpson,2381 Tiffany Groves Suite 813,,,,,,,,,United Kingdom,GB,Southwark,Nunhead,Bandcamp search,bandcamp.com/app/android/search
451,1/18/20 12:19am,Bandcamp,album,Music from Saharan WhatsApp,Etran de L'Aïr,USD,2.0,1.0,,2.0,,,,0.17,paypal,2.0,0.0,3956310723,,0.2,0.2,0.0,1.63,441.62,1.63,digital download,,http://etrandelair.bandcamp.com/album/music-from-saharan-whatsapp,,WHATSAPP-01,,,Christine Munoz,melissafisher@yahoo.com,114.365.8945,,Brandon Bruce,358 Kimberly Roads Suite 392,,,,,,,,,Australia,AU,NSW,Sydney,,
452,1/18/20 12:33am,Bandcamp,album,Music from Saharan WhatsApp,Etran de L'Aïr,USD,1.0,1.0,,1.0,,,,0.1,credit card,1.0,0.0,3460816953,,0.1,0.1,0.0,0.8,442.42,0.8,digital download,,http://etrandelair.bandcamp.com/album/music-from-saharan-whatsapp,,WHATSAPP-01,,,Kevin Hughes,sprice@davis-webb.com,+1-661-719-2479x235,,Lindsey Gibson,626 Adams Summit,,,,,,,,,United States,US,ME,Falmouth,Publish notice sent to your fans,
453,1/18/20 1:13am,Bandcamp,album,Music from Saharan WhatsApp,Etran de L'Aïr,USD,1.0,1.0,,1.0,,,,0.1,paypal,1.0,0.0,1773421451,,0.1,0.1,0.0,0.8,443.22,0.8,digital download,,http://etrandelair.bandcamp.com/album/music-from-saharan-whatsapp,,WHATSAPP-01,,,Emily Fisher,sdavis@yahoo.com,3237915169,,Chloe Neal,8334 Bryant Curve Suite 989,,,,,,,,,United States,US,FL,Windermere,,
454,1/18/20 3:51am,Bandcamp,album,Music from Saharan WhatsApp,Etran de L'Aïr,USD,5.0,1.0,,5.0,,,,0.3,paypal,5.0,0.0,1245330479,,0.5,0.5,0.0,4.2,447.42,4.2,digital download,,http://etrandelair.bandcamp.com/album/music-from-saharan-whatsapp,,WHATSAPP-01,,,Judith Johnson,lporter@gonzalez-pena.biz,420-497-2349x9911,,Calvin Spence,45561 Dyer Mission Suite 583,,,,,,,,,United States,US,IL,Oak Park,Twitter,t.co/qvf0Q5hRhg?amp=1
455,1/18/20 4:19am,Bandcamp,album,Music from Saharan WhatsApp,Etran de L'Aïr,USD,1.0,1.0,,1.0,,,,0.1,credit card,1.0,0.0,3879831077,,0.1,0.1,0.0,0.8,448.22,0.8,digital download,,http://etrandelair.bandcamp.com/album/music-from-saharan-whatsapp,,WHATSAPP-01,,,Cassandra Fischer,yhardy@ramirez.info,(935)678-3903,,Misty Martin,8551 Christopher Mountains Apt. 734,,,,,,,,,United States,US,MN,Minneapolis,Bandcamp weekly newsletter,bandcamp.com
456,1/18/20 5:25am,Bandcamp,album,Music from Saharan WhatsApp,Etran de L'Aïr,USD,3.0,1.0,,3.0,,,,0.23,credit card,3.0,0.0,614203187,,0.3,0.3,0.0,2.47,450.69,2.47,digital download,,http://etrandelair.bandcamp.com/album/music-from-saharan-whatsapp,,WHATSAPP-01,,,Adam Cline,wmorris@cervantes-arnold.com,(258)776-3475,,Crystal Johnson,57090 Smith Cliff,,,,,,,,,New Zealand,NZ,Canterbury,Christchurch,Publish notice sent to your fans,
457,1/18/20 5:45am,Bandcamp,album,Music from Saharan WhatsApp,Etran de L'Aïr,USD,2.0,1.0,,2.0,,,,0.15,credit card,2.0,0.0,3725687492,,0.2,0.2,0.0,1.65,452.34,1.65,digital download,,http://etrandelair.bandcamp.com/album/music-from-saharan-whatsapp,,WHATSAPP-01,,,Brandon Rivera,abigail95@castro-deleon.net,(785)125-1695,,Ryan Smith,77631 Garcia Tunnel,,,,,,,,,United States,US,CO,Lafayette,Publish notice sent to your fans,
458,1/18/20 6:39am,Bandcamp,album,Music from Saharan WhatsApp,Etran de L'Aïr,USD,3.0,1.0,,3.0,,,,0.23,credit card,3.0,0.0,2138515921,,0.3,0.3,0.0,2.47,454.81,2.47,digital download,,http://etrandelair.bandcamp.com/album/music-from-saharan-whatsapp,,WHATSAPP-01,,,Larry White,joel64@hotmail.com,9749576382,,Michael Herring,4845 Kerry Villages,,,,,,,,,United Kingdom,GB,Hertfordshire,St Albans,Publish notice sent to your fans,
459,1/18/20 7:34am,Bandcamp,album,Music from Saharan WhatsApp,Etran de L'Aïr,USD,4.0,1.0,,4.0,,,,0.29,credit card,4.0,0.0,4049721785,,0.4,0.4,0.0,3.31,458.12,3.31,digital download,,http://etrandelair.bandcamp.com/album/music-from-saharan-whatsapp,,WHATSAPP-01,,,Debra Williams,manuellevy@yahoo.com,563.016.2221,,Crystal Clark,472 Kevin Hills Suite 501,,,,,,,,,Australia,AU,NSW,Newtown,Bandcamp search,bandcamp.com/autocomplete-search
460,1/18/20 10:03am,Bandcamp,album,Music from Saharan WhatsApp,Etran de L'Aïr,USD,1.0,1.0,,1.0,,,,0.11,paypal,1.0,0.0,80980456,,0.1,0.1,0.0,0.79,458.91,0.79,digital download,,http://etrandelair.bandcamp.com/album/music-from-saharan-whatsapp,,WHATSAPP-01,,,Alejandro Livingston,jacksonlinda@yahoo.com,639-637-4455,,Pamela Crawford,3684 Herman Gateway,,,,,,,,,Germany,DE,Land Berlin,Berlin,Bandcamp artist: etrandelair,etrandelair.bandcamp.com/album/music-from-saharan-whatsapp
461,1/18/20 10:08am,Bandcamp,album,Music from Saharan WhatsApp,Etran de L'Aïr,USD,3.0,1.0,,3.0,,,,0.23,paypal,3.0,0.0,1555049456,,0.3,0.3,0.0,2.47,461.38,2.47,digital download,,http://etrandelair.bandcamp.com/album/music-from-saharan-whatsapp,,WHATSAPP-01,,,Hayley Nicholson,powerstammie@friedman-morton.com,407.191.5276x08282,,Caleb Clarke,65052 Gina Burgs,,,,,,,,,United Kingdom,GB,England,London,Bandcamp search,bandcamp.com/app/android/search
462,1/18/20 10:32am,Bandcamp,package,Ilana: The Creator,Mdou Moctar,USD,17.0,1.0,,17.0,,5.0,United States,0.72,paypal,22.0,0.0,3363744542,,1.7,1.7,0.0,19.58,480.96,14.58,Ilana LP,,http://mdoumoctar.bandcamp.com/album/ilana-the-creator,SS-051lp,SS-051,602318 136893,,Andrea Carter,carpentermaria@adams.info,(128)869-4876,,Melissa Torres,2547 Jessica Isle,Apt A3,Seattle,WA,98117,United States,US,1/21/20,,United States,US,WA,Seattle,Google search,www.google.com/
463,1/18/20 10:44am,Bandcamp,album,La Musique Electronique du Niger,Mamman Sani,USD,15.0,1.0,,15.0,1.4,,,0.82,credit card,16.4,0.0,2217108838,,1.5,1.5,0.0,12.68,493.64,12.68,digital download,,http://mammansani.bandcamp.com/album/la-musique-electronique-du-niger,,SS-011,889326 664864,,Antonio Lee,lisa73@yahoo.com,+1-226-696-6370x5691,,Ann Johnson,384 Tina Mountains,,,,,,,,,France,FR,Seine-Saint-Denis,Livry-Gargan,Google search,www.google.com/
464,1/18/20 11:29am,Bandcamp,album,Music from Saharan WhatsApp,Etran de L'Aïr,USD,2.0,1.0,,2.0,,,,0.17,paypal,2.0,0.0,102521499,,0.2,0.2,0.0,1.63,495.27,1.63,digital download,,http://etrandelair.bandcamp.com/album/music-from-saharan-whatsapp,,WHATSAPP-01,,,Jessica Martin,andersonamanda@casey.biz,+1-421-097-2238x28337,,Brandon Alexander,030 John Views,,,,,,,,,Canada,CA,ON,Whitby,Facebook,m.facebook.com
465,1/18/20 11:31am,Bandcamp,album,Music from Saharan WhatsApp,Etran de L'Aïr,USD,4.0,1.0,,4.0,,,,0.29,credit card,4.0,0.0,124800703,,0.4,0.4,0.0,3.31,498.58,3.31,digital download,,http://etrandelair.bandcamp.com/album/music-from-saharan-whatsapp,,WHATSAPP-01,,,Ashley Taylor,jrodriguez@reyes-cervantes.com,+1-901-136-8534x69677,,Karen Hoffman,8443 Gutierrez Mills,,,,,,,,,Germany,DE,Land Berlin,Berlin,Facebook,www.facebook.com
466,1/18/20 3:22pm,Bandcamp,album,Falaw,Luka Productions,USD,7.0,1.0,,7.0,,,,0.4,paypal,7.0,0.0,2549925653,,0.7,0.7,0.0,5.9,504.48,5.9,digital download,,http://lukaproductions.bandcamp.com/album/falaw,,SS-052,602318 136855,,Stuart Perry,randybarker@hotmail.com,+1-875-315-2632,,David Harris,30396 Danielle Greens,,,,,,,,,United States,US,CO,Denver,,
467,1/18/20 4:06pm,Bandcamp,album,Ilana: The Creator,Mdou Moctar,USD,7.0,1.0,,7.0,,,,0.4,paypal,7.0,0.0,923839998,,0.7,0.7,0.0,5.9,510.38,5.9,digital download,,http://mdoumoctar.bandcamp.com/album/ilana-the-creator,,SS-051,602318 136893,,John Romero,wwashington@pacheco-diaz.com,227-178-8401x4112,,Samuel Ward,84561 Harmon Summit Apt. 501,,,,,,,,,United States,US,CT,Storrs,Bandcamp search,bandcamp.com/app/ios/search
468,1/18/20 4:16pm,Bandcamp,album,Music from Saharan WhatsApp,Etran de L'Aïr,USD,2.0,1.0,,2.0,,,,0.17,credit card,2.0,0.0,3107198828,,0.2,0.2,0.0,1.63,512.01,1.63,digital download,,http://etrandelair.bandcamp.com/album/music-from-saharan-whatsapp,,WHATSAPP-01,,,Steven Hahn,teresa46@mclean.net,0250494371,,Shelley Gross,244 Day Extensions Suite 924,,,,,,,,,Germany,DE,Land Berlin,Berlin,Bandcamp weekly newsletter,bandcamp.com
469,1/18/20 4:25pm,Bandcamp,album,Ilana: The Creator,Mdou Moctar,USD,7.0,1.0,,7.0,1.54,,,0.55,paypal,8.54,0.0,823739913,,0.7,0.7,0.0,5.75,517.76,5.75,digital download,,http://mdoumoctar.bandcamp.com/album/ilana-the-creator,,SS-051,602318 136893,,Francisco Acosta,thompsonrichard@hood.com,257.698.5455x73674,,Kathleen Meyer,153 Rosario Run Apt. 250,,,,,,,,,Italy,IT,Milan,Milan,Bandcamp search,bandcamp.com/app/android/search
470,1/18/20 4:35pm,Bandcamp,package,Taaritt,Mamman Sani,USD,17.0,1.0,,17.0,,5.0,United States,0.78,credit card,22.0,0.0,3559323595,,1.7,1.7,0.0,19.52,537.28,14.52,Taaritt LP,,http://mammansani.bandcamp.com/album/taaritt,SS-023lp,SS-023,889326 664871,,Adam Cortez,dlogan@moore.com,+1-807-446-9380x5175,,Heather Wilson,112 Hernandez Crossing Suite 782,,New Orleans,LA,70115,United States,US,1/21/20,,United States,US,LA,New Orleans,,
471,1/18/20 4:57pm,Bandcamp,album,Music from Saharan WhatsApp,Etran de L'Aïr,USD,5.0,1.0,,5.0,,,,0.35,paypal,5.0,0.0,433826847,,0.5,0.5,0.0,4.15,541.43,4.15,digital download,,http://etrandelair.bandcamp.com/album/music-from-saharan-whatsapp,,WHATSAPP-01,,,William Ward,meganwilliams@farmer-chapman.org,095.279.3776x0794,,Nancy Arnold,420 Shah Common Suite 017,,,,,,,,,France,FR,Aisne,Saint-Quentin,Bandcamp weekly newsletter,bandcamp.com
472,1/18/20 5:10pm,Bandcamp,album,Music from Saharan Cellphones,Various,USD,10.0,1.0,,10.0,,,,0.59,paypal,10.0,0.0,94594041,,1.0,1.0,0.0,8.41,549.84,8.41,digital download,,http://sahelsounds.bandcamp.com/album/music-from-saharan-cellphones,,SS-003,889326 667889,,Carrie Johnson,bsalinas@hotmail.com,+1-865-604-4115x899,,Mary Craig,3841 Jessica Key,,,,,,,,,Maldives,MV,Kaafu Atoll,Malé,,
473,1/18/20 6:02pm,shop@sahelsounds.com,payout,,,USD,,,,,,,,0.91,transfer,91.39,90.48,t252229922,8BC81995N7513920B,,,,-91.39,458.45,,,,,,,,,,,,,,,,,,,,,,,,,,,,
474,1/18/20 6:02pm,shop@sahelsounds.com,payout,,,USD,,,,,,,,2.75,transfer,274.63,271.88,t252229923,7SS56868JC891305K,,,,-274.63,183.82,,,,,,,,,,,,,,,,,,,,,,,,,,,,
475,1/18/20 7:05pm,Bandcamp,album,Music from Saharan WhatsApp,Etran de L'Aïr,USD,5.0,1.0,,5.0,,,,0.3,gift card,5.0,0.0,2749636613,,0.5,0.5,0.0,4.2,188.02,4.2,digital download,,http://etrandelair.bandcamp.com/album/music-from-saharan-whatsapp,,WHATSAPP-01,,,Dawn Woods,juanrichard@spencer.com,9637542584,,Frederick Anderson,808 Anthony Springs Apt. 365,,,,,,,,,United States,US,IL,Peoria,Facebook,www.facebook.com
476,1/18/20 8:56pm,Bandcamp,package,Ilana: The Creator,Mdou Moctar,USD,17.0,1.0,,17.0,,5.0,United States,0.72,paypal,22.0,0.0,2328603253,,1.7,1.7,0.0,19.58,207.6,14.58,Ilana LP,,http://mdoumoctar.bandcamp.com/album/ilana-the-creator,SS-051lp,SS-051,602318 136893,,Michelle Rios,bakerheather@yahoo.com,001-178-543-6954x29627,,Kelly Clark,766 Harris Freeway Suite 630,,Vancouver,WA,98683,United States,US,1/21/20,,United States,US,WA,Vancouver,,
477,1/18/20 9:02pm,Bandcamp,album,Music from Saharan WhatsApp,Etran de L'Aïr,USD,1.0,1.0,,1.0,,,,0.11,paypal,1.0,0.0,474007087,,0.1,0.1,0.0,0.79,208.39,0.79,digital download,,http://etrandelair.bandcamp.com/album/music-from-saharan-whatsapp,,WHATSAPP-01,,,Anna Cox,brandy06@yahoo.com,(496)969-8381,,Brandon Estrada,099 Schneider Shoal,,,,,,,,,United Kingdom,GB,Glasgow City,Glasgow,Bandcamp release notification: music feed,http://blog.bandcamp.com/2014/01/30/bandcamp-app-now-with-music-feed/
478,1/18/20 10:20pm,Bandcamp,album,Field Recordings from the Sahel,Sahel Sounds,USD,1.0,1.0,,1.0,,,,0.11,credit card,1.0,0.0,1763226966,,0.1,0.1,0.0,0.79,209.18,0.79,digital download,,http://sahelsounds.bandcamp.com/album/field-recordings-from-the-sahel,,SS-057,602318 137104,,Tiffany Cook,xoliver@yahoo.com,+1-813-390-5394x9824,,Jamie Hunt,5102 Church Expressway,,,,,,,,,United Kingdom,GB,Bromley,Beckenham,youtube.com,www.youtube.com/
479,1/18/20 10:36pm,Bandcamp,album,Sahel Sounds Label Sampler,Various Artists,USD,1.0,1.0,,1.0,,,,0.11,paypal,1.0,0.0,4251147559,,0.1,0.1,0.0,0.79,209.97,0.79,digital download,,http://sahelsounds.bandcamp.com/album/sahel-sounds-label-sampler,,SS-058,602318 137111,,Kristy Smith,joannkelly@yahoo.com,733-233-3533x94719,,Carrie Martinez,681 Michael Skyway Apt. 499,,,,,,,,,United Kingdom,GB,Plymouth,Plymouth,Bandcamp search,bandcamp.com/app/android/search
480,1/18/20 10:59pm,Bandcamp,album,Ilana: The Creator,Mdou Moctar,USD,10.0,1.0,,10.0,,,,0.59,paypal,10.0,0.0,2767917121,,1.0,1.0,0.0,8.41,218.38,8.41,digital download,,http://mdoumoctar.bandcamp.com/album/ilana-the-creator,,SS-051,602318 136893,,Virginia Hoffman,gregory79@jackson.com,025-081-6277,,Debbie Martin,5946 Bryan Ford,,,,,,,,,Australia,AU,VIC,Doncaster East,Bandcamp fan page: oneoneone1,bandcamp.com/oneoneone1
481,1/19/20 1:50am,Bandcamp,album,Music from Saharan WhatsApp,Etran de L'Aïr,USD,4.0,1.0,,4.0,,,,0.65,credit card,4.0,0.0,3100908851,,0.4,0.0,0.4,0.0,218.38,2.95,digital download,,http://etrandelair.bandcamp.com/album/music-from-saharan-whatsapp,,WHATSAPP-01,,,Caitlin Gates,briandavis@galloway-owens.com,+1-577-550-7236x86535,,Sherri Logan,62411 Allen Oval,,,,,,,,,Australia,AU,NSW,Sydney,Bandcamp music feed: andrewleeson - summerbreeze1,http://blog.bandcamp.com/2013/09/19/strap-on-your-feed-bag/
482,1/19/20 1:50am,Bandcamp,album,No. 1,Etran de L'Aïr,USD,7.0,1.0,,7.0,,,,,,7.0,0.0,3100908851,,0.7,1.1,0.0,9.25,227.63,6.3,digital download,,http://etrandelair.bandcamp.com/album/no-1,,SS-045,602318 136824,,Amanda Hines,markballard@gmail.com,807-430-4202x75123,,Jennifer King,729 Sims Knolls,,,,,,,,,Australia,AU,NSW,Sydney,Bandcamp music feed: andrewleeson - summerbreeze1,http://blog.bandcamp.com/2013/09/19/strap-on-your-feed-bag/
483,1/19/20 2:08am,Bandcamp,album,Music from Saharan WhatsApp,Etran de L'Aïr,USD,3.0,1.0,,3.0,,,,0.23,credit card,3.0,0.0,1217034981,,0.3,0.3,0.0,2.47,230.1,2.47,digital download,,http://etrandelair.bandcamp.com/album/music-from-saharan-whatsapp,,WHATSAPP-01,,,Karen Duffy,jamesgreen@murphy.com,001-690-073-2845x7789,,Keith Shelton,3090 Stephen Squares Suite 077,,,,,,,,,Australia,AU,VIC,Melbourne,Bandcamp New & Notable,bandcamp.com/#new-notable
484,1/19/20 4:37am,Bandcamp,album,Houmeissa,Hama,USD,7.0,1.0,,7.0,,,,0.92,credit card,7.0,0.0,4089339748,,0.7,0.0,0.7,0.0,230.1,5.38,digital download,,http://hamasynth.bandcamp.com/album/houmeissa,,SS-049,656605 382364,,Christina Holland,emilyjohnson@taylor-davis.biz,+1-954-524-2111x5263,,Andrea Little,065 Davis Creek Apt. 716,,,,,,,,,United States,US,VT,Burlington,smarturl.it,smarturl.it/lukaproductions
485,1/19/20 4:37am,Bandcamp,album,Falaw,Luka Productions,USD,7.0,1.0,,7.0,,,,,,7.0,0.0,4089339748,,0.7,0.0,1.4,0.0,230.1,6.3,digital download,,http://lukaproductions.bandcamp.com/album/falaw,,SS-052,602318 136855,,Joshua Marshall,simsmelissa@hotmail.com,(872)472-5596x731,,Alexander Rich,4084 Cristian Glens,,,,,,,,,United States,US,VT,Burlington,,
486,1/19/20 4:37am,Bandcamp,album,Eghass Malan,Les Filles de Illighadad,USD,7.0,1.0,,7.0,,,,,,7.0,0.0,4089339748,,0.7,0.0,2.1,0.0,230.1,6.3,digital download,,http://lesfillesdeillighadad.bandcamp.com/album/eghass-malan,,SS-044,191515 928351,,Amy Murray,jessica57@yahoo.com,(772)639-7333x50284,,Lisa Green,5359 Pitts Island,,,,,,,,,United States,US,VT,Burlington,smarturl.it,smarturl.it/lukaproductions
487,1/19/20 4:37am,Bandcamp,album,Les Filles de Illighadad,Les Filles de Illighadad,USD,7.0,1.0,,7.0,,,,,,7.0,0.0,4089339748,,0.7,2.8,0.0,24.28,254.38,6.3,digital download,,http://lesfillesdeillighadad.bandcamp.com/album/les-filles-de-illighadad,,SS-033,889326 664918,,Katrina Flowers,preston11@roth-mitchell.com,836.789.7015x332,,Cory Malone,5297 Gabriel Bridge Suite 804,,,,,,,,,United States,US,VT,Burlington,,
488,1/19/20 5:12am,Bandcamp,album,Music from Saharan Cellphones,Various,USD,10.0,1.0,,10.0,,,,0.52,credit card,10.0,0.0,2969221708,,1.0,1.0,0.0,8.48,262.86,8.48,digital download,,http://sahelsounds.bandcamp.com/album/music-from-saharan-cellphones,,SS-003,889326 667889,,David Cunningham,stephaniemorse@yahoo.com,9912241343,,Bruce Miller,91144 Calvin Ranch,,,,,,,,,United States,US,MI,Ypsilanti,Google search,www.google.com/
489,1/19/20 7:13am,Bandcamp,album,Music from Saharan Cellphones,Various,USD,10.0,1.0,,10.0,,,,0.49,paypal,10.0,0.0,2207287759,,1.0,1.0,0.0,8.51,271.37,8.51,digital download,,http://sahelsounds.bandcamp.com/album/music-from-saharan-cellphones,,SS-003,889326 667889,,Christopher Allen,lbailey@yahoo.com,987.659.8797,,Kayla Reynolds,62661 Barbara Stravenue Suite 952,,,,,,,,,United States,US,TX,Alvin,tumblr.com,www.tumblr.com/
490,1/19/20 8:17am,Bandcamp,album,Music from Saharan WhatsApp,Etran de L'Aïr,USD,1.0,1.0,,1.0,,,,0.11,credit card,1.0,0.0,1381387220,,0.1,0.1,0.0,0.79,272.16,0.79,digital download,,http://etrandelair.bandcamp.com/album/music-from-saharan-whatsapp,,WHATSAPP-01,,,Donna Wiggins,masonadam@yahoo.com,644.230.7835x0542,,Rebecca Bruce,672 Becky Via Suite 642,,,,,,,,,Luxembourg,LU,,,,
491,1/19/20 9:25am,Bandcamp,album,Music from Saharan WhatsApp,Etran de L'Aïr,USD,1.0,1.0,,1.0,,,,0.1,credit card,1.0,0.0,1248589429,,0.1,0.1,0.0,0.8,272.96,0.8,digital download,,http://etrandelair.bandcamp.com/album/music-from-saharan-whatsapp,,WHATSAPP-01,,,Diana Scott,georgegarcia@hotmail.com,(420)014-0246x75507,,David Allen,193 Davis Crossing,,,,,,,,,United States,US,MO,St Louis,Bandcamp artist: sahelsounds,sahelsounds.bandcamp.com/album/sahel-sounds-label-sampler
492,1/19/20 10:25am,Bandcamp,album,Anou Malane,Abdallah Ag Oumbadougou,USD,8.0,1.0,,8.0,1.47,,,0.57,paypal,9.47,0.0,3654581689,,0.8,0.8,0.0,6.63,279.59,6.63,digital download,,http://abdallahagoumbadougou.bandcamp.com/album/anou-malane,,SS-053,602318 136992,,John Howard,martinezhannah@richmond.com,394.845.6836x46782,,Kelly Allison,5177 Christopher Brooks,,,,,,,,,Belgium,BE,Brussels Capital,Ixelles-Elsene,Facebook,m.facebook.com
493,1/19/20 1:39pm,Bandcamp,album,Eghass Malan,Les Filles de Illighadad,USD,7.0,1.0,,7.0,,,,0.57,paypal,7.0,0.0,2625960191,,0.7,0.0,0.7,0.0,279.59,5.73,digital download,,http://lesfillesdeillighadad.bandcamp.com/album/eghass-malan,,SS-044,191515 928351,,Holly Johnson,courtney37@humphrey.com,(997)751-8391x33934,,Angelica Cannon,374 Baker Summit Apt. 351,,,,,,,,,United States,US,IL,La Grange,,
494,1/19/20 1:39pm,Bandcamp,album,Les Filles de Illighadad,Les Filles de Illighadad,USD,7.0,1.0,,7.0,,,,,,7.0,0.0,2625960191,,0.7,1.4,0.0,12.03,291.62,6.3,digital download,,http://lesfillesdeillighadad.bandcamp.com/album/les-filles-de-illighadad,,SS-033,889326 664918,,Charles Bishop,bfreeman@hotmail.com,904.930.2671x32911,,Tonya Clark,32498 Wilson Fall Suite 662,,,,,,,,,United States,US,IL,La Grange,,
495,1/19/20 2:00pm,Bandcamp,album,Music from Saharan Cellphones,Various,USD,7.0,1.0,,7.0,,,,0.4,paypal,7.0,0.0,3756263521,,0.7,0.7,0.0,5.9,297.52,5.9,digital download,,http://sahelsounds.bandcamp.com/album/music-from-saharan-cellphones,,SS-003,889326 667889,,Scott Cole,ldavis@campbell.net,808-701-4586x4785,,Dale Foster,793 Jennifer Meadow,,,,,,,,,United States,US,NY,New York,,
496,1/19/20 2:20pm,Bandcamp,package,Zerzura (Original Soundtrack Recording),Ahmoudou Madassane,USD,15.0,1.0,,15.0,,10.0,United States,1.03,paypal,25.0,0.0,4057895280,,1.5,1.5,0.0,22.47,319.99,12.47,Zerzura DVD,,http://sahelsounds.bandcamp.com/merch/zerzura-dvd,SS-046DVD,,,,Mark Huber,grace11@yahoo.com,(875)689-4212,,Jessica Li,572 Nathaniel Summit Apt. 982,,Garching bei München,,85748,Germany,DE,1/21/20,,Germany,DE,,Garching bei München,,
497,1/19/20 2:24pm,Bandcamp,album,L'Orchestre National de Mauritanie - La Mone / Kamlat,L'Orchestre National de Mauritanie,USD,1.0,1.0,,1.0,,,,0.11,credit card,1.0,0.0,2219424014,,0.1,0.1,0.0,0.79,320.78,0.79,digital download,,http://lorchestrenationaldemauritanie.bandcamp.com/album/lorchestre-national-de-mauritanie-la-mone-kamlat,,SS-002,889326 664949,,Richard Mitchell,qlee@schwartz.com,585.542.9010x9966,,Nicole Mccoy,87264 Romero Squares,,,,,,,,,Belgium,BE,East Flanders Province,Ghent,Recommendations footer: artist recommendation,bandcamp.com/footer/ar/a95753531
498,1/19/20 4:03pm,Bandcamp,album,Music from Saharan WhatsApp,Etran de L'Aïr,USD,3.0,1.0,,3.0,,,,0.23,paypal,3.0,0.0,371483445,,0.3,0.3,0.0,2.47,323.25,2.47,digital download,,http://etrandelair.bandcamp.com/album/music-from-saharan-whatsapp,,WHATSAPP-01,,,Kelly Reid,sherryjohnson@carter-richardson.com,003.556.1865,,Amanda Davis,481 Andrea Circles Suite 698,,,,,,,,,Canada,CA,ON,Toronto,Facebook,www.facebook.com
499,1/19/20 5:30pm,Bandcamp,album,Music from Saharan WhatsApp,Etran de L'Aïr,USD,1.0,1.0,,1.0,,,,0.11,paypal,1.0,0.0,176183772,,0.1,0.1,0.0,0.79,324.04,0.79,digital download,,http://etrandelair.bandcamp.com/album/music-from-saharan-whatsapp,,WHATSAPP-01,,,Aaron Ortiz,wfowler@hotmail.com,(087)923-2481x322,,Anthony Moon,59994 Garner Isle Apt. 626,,,,,,,,,United Kingdom,GB,Leeds,Leeds,Bandcamp music feed,http://blog.bandcamp.com/2014/01/30/bandcamp-app-now-with-music-feed/
500,1/19/20 5:45pm,Bandcamp,album,No. 1,Etran de L'Aïr,USD,7.0,1.0,,7.0,1.33,,,0.69,credit card,8.33,0.0,2372020473,,0.7,0.0,0.7,0.0,324.04,5.61,digital download,,http://etrandelair.bandcamp.com/album/no-1,,SS-045,602318 136824,,Andrea Francis,samantha63@hotmail.com,3640162678,,Dustin Padilla,94895 Cassandra Loop,,,,,,,,,Germany,DE,North Rhine-Westphalia,Cologne,,
501,1/19/20 5:45pm,Bandcamp,album,Music from Saharan WhatsApp,Etran de L'Aïr,USD,4.0,1.0,,4.0,,,,,,4.0,0.0,2372020473,,0.4,1.1,0.0,9.21,333.25,3.6,digital download,,http://etrandelair.bandcamp.com/album/music-from-saharan-whatsapp,,WHATSAPP-01,,,Larry Ortiz,allenbenjamin@gmail.com,367.799.0427,,Megan Morris,5826 Reid Path Apt. 383,,,,,,,,,Germany,DE,North Rhine-Westphalia,Cologne,,
502,1/19/20 6:02pm,shop@sahelsounds.com,payout,,,USD,,,,,,,,1.02,transfer,102.35,101.33,t252455299,86658052XC270961M,,,,-102.35,230.9,,,,,,,,,,,,,,,,,,,,,,,,,,,,
503,1/19/20 6:02pm,shop@sahelsounds.com,payout,,,USD,,,,,,,,0.81,transfer,81.47,80.66,t252455281,0A4604825R306524G,,,,-81.47,149.43,,,,,,,,,,,,,,,,,,,,,,,,,,,,
504,1/19/20 7:13pm,Bandcamp,album,Music from Saharan WhatsApp,Etran de L'Aïr,USD,3.0,1.0,,3.0,,,,0.2,paypal,3.0,0.0,3986467016,,0.3,0.3,0.0,2.5,151.93,2.5,digital download,,http://etrandelair.bandcamp.com/album/music-from-saharan-whatsapp,,WHATSAPP-01,,,Rachel Franco,rebeccamorgan@davis-massey.com,652-790-7646x709,,Mary Williamson,9276 Sarah Curve Suite 395,,,,,,,,,United States,US,CA,Sacramento,Bandcamp release notification: music feed,http://blog.bandcamp.com/2014/01/30/bandcamp-app-now-with-music-feed/
505,1/19/20 7:27pm,Bandcamp,album,Tiris,El Wali,USD,7.0,1.0,,7.0,1.4,,,0.57,credit card,8.4,0.0,4027406935,,0.7,0.7,0.0,5.73,157.66,5.73,digital download,,http://elwali.bandcamp.com/album/tiris,,SS-055,602318 136923,,Brian Rush,jeremy36@hotmail.com,001-935-409-4005x86017,,Gregory Smith,53387 Jason Divide Suite 937,,,,,,,,,United Kingdom,GB,Haringey,Tottenham,Bandcamp search: “tiris”,bandcamp.com/search?q=tiris
506,1/19/20 9:57pm,Bandcamp,album,Music from Saharan WhatsApp,Etran de L'Aïr,USD,1.0,1.0,,1.0,,,,0.1,credit card,1.0,0.0,3595130071,,0.1,0.1,0.0,0.8,158.46,0.8,digital download,,http://etrandelair.bandcamp.com/album/music-from-saharan-whatsapp,,WHATSAPP-01,,,Brian Smith,rphillips@valenzuela.info,(797)134-8259x1865,"Hello Etran de L'Air........your music is lovely and I am grateful to Sahel Sounds for making it available. I have a radio show here in the States and will be airing your EP. Thank you so much, and I wish you all the best. Mark Taylor",Joshua Brock,1211 Steven Parkways,,,,,,,,,United States,US,PA,Chadds Ford,,
507,1/19/20 10:30pm,Bandcamp,album,Music from Saharan WhatsApp,Etran de L'Aïr,USD,2.0,1.0,,2.0,,,,0.15,credit card,2.0,0.0,1174838642,,0.2,0.2,0.0,1.65,160.11,1.65,digital download,,http://etrandelair.bandcamp.com/album/music-from-saharan-whatsapp,,WHATSAPP-01,,,Anna Perez,jennifergarcia@yahoo.com,0972628164,,Denise Duffy,35547 Robert Courts Apt. 648,,,,,,,,,United States,US,NM,Albuquerque,Publish notice sent to your fans,
508,1/19/20 10:34pm,Bandcamp,album,Afelan,Mdou Moctar,USD,7.0,1.0,,7.0,,,,0.61,credit card,7.0,0.0,873098700,,0.7,0.0,0.7,0.0,160.11,5.69,digital download,,http://mdoumoctar.bandcamp.com/album/afelan,,SS-017,889326 664840,,Samantha Shea,johnsondouglas@leonard-french.com,750.940.9205x1475,,Sarah Martin,447 Vasquez Throughway,,,,,,,,,United States,US,CA,Costa Mesa,en.wikipedia.org,en.wikipedia.org/
509,1/19/20 10:34pm,Bandcamp,album,Akounak Tedalat Taha Tazoughai OST,Mdou Moctar,USD,7.0,1.0,,7.0,,,,,,7.0,0.0,873098700,,0.7,1.4,0.0,11.99,172.1,6.3,digital download,,http://mdoumoctar.bandcamp.com/album/akounak-tedalat-taha-tazoughai-ost,,SS-028,889326 667599,,Chelsea Lloyd,masseyrachel@larson-hamilton.com,+1-578-842-3111x72016,,Autumn Walker,21720 Troy Field,,,,,,,,,United States,US,CA,Costa Mesa,,
510,1/19/20 10:57pm,Bandcamp,album,Music from Saharan WhatsApp,Etran de L'Aïr,USD,5.0,1.0,,5.0,,,,0.3,credit card,5.0,0.0,1034608090,,0.5,0.5,0.0,4.2,176.3,4.2,digital download,,http://etrandelair.bandcamp.com/album/music-from-saharan-whatsapp,,WHATSAPP-01,,,Stephanie Griffin,welchchris@kirk.com,+1-589-814-5506x983,,Cheryl Davidson,454 Tiffany Tunnel,,,,,,,,,United States,US,CA,Costa Mesa,,
511,1/19/20 11:16pm,Bandcamp,album,Music from Saharan WhatsApp,Etran de L'Aïr,USD,3.0,1.0,,3.0,,,,0.2,paypal,3.0,0.0,1864059650,,0.3,0.3,0.0,2.5,178.8,2.5,digital download,,http://etrandelair.bandcamp.com/album/music-from-saharan-whatsapp,,WHATSAPP-01,,,Veronica Jones,christopher61@reyes.com,+1-389-263-4655,,Eugene Garcia,0797 Louis Junction Apt. 847,,,,,,,,,United States,US,IL,Skokie,Google search,www.google.com/
512,1/20/20 12:28am,Bandcamp,album,Music from Saharan WhatsApp,Etran de L'Aïr,USD,6.0,1.0,,6.0,,,,0.35,paypal,6.0,0.0,4088475922,,0.6,0.6,0.0,5.05,183.85,5.05,digital download,,http://etrandelair.bandcamp.com/album/music-from-saharan-whatsapp,,WHATSAPP-01,,,Christopher Hodges,mccoycurtis@hotmail.com,(234)253-7648x77505,,Kelly Bush,43514 Ashley Center Suite 240,,,,,,,,,United States,US,WA,Tacoma,Facebook,m.facebook.com
513,1/20/20 12:34am,Bandcamp,album,Music from Saharan WhatsApp,Etran de L'Aïr,USD,1.5,1.0,,1.5,,,,0.13,paypal,1.5,0.0,2295036510,,0.15,0.15,0.0,1.22,185.07,1.22,digital download,,http://etrandelair.bandcamp.com/album/music-from-saharan-whatsapp,,WHATSAPP-01,,,Holly Bruce,lee80@yahoo.com,(442)869-7970x565,,Terrance Swanson,090 Kim Rapid,,,,,,,,,United Kingdom,GB,Lambeth,Balham,Google search,www.google.com/
514,1/20/20 1:28am,Bandcamp,package,Ilana: The Creator,Mdou Moctar,USD,45.0,1.0,,45.0,,6.0,United States,1.27,paypal,51.0,0.0,1661223120,,4.5,4.5,0.0,45.23,230.3,39.23,Ilana The Creator shirt & LP bundle,LARGE,http://mdoumoctar.bandcamp.com/merch/ilana-the-creator-shirt-lp-bundle,SS-051lp*-T02-W-ULG,,,,Krista Fletcher,kimcharles@hotmail.com,171-156-2452,,Michele Johnson,8283 Shepherd Valleys,,Coral Springs,FL,33071,United States,US,1/21/20,,United States,US,FL,Coral Springs,Bandcamp home page,bandcamp.com/
515,1/20/20 1:41am,Bandcamp,album,Music from Saharan WhatsApp,Etran de L'Aïr,USD,1.0,1.0,,1.0,,,,0.1,credit card,1.0,0.0,1269386185,,0.1,0.1,0.0,0.8,231.1,0.8,digital download,,http://etrandelair.bandcamp.com/album/music-from-saharan-whatsapp,,WHATSAPP-01,,,Timothy Price,nicholas72@yahoo.com,+1-644-401-7119,,Timothy Williams,5066 Ibarra Trail,,,,,,,,,United States,US,MO,Kansas City,Bandcamp search,bandcamp.com/autocomplete-search
516,1/20/20 2:45am,Bandcamp,package,Ilana: The Creator,Mdou Moctar,USD,17.0,1.0,,17.0,,5.0,United States,0.72,paypal,22.0,0.0,691112382,,1.7,1.7,0.0,19.58,250.68,14.58,Ilana LP,,http://mdoumoctar.bandcamp.com/album/ilana-the-creator,SS-051lp,SS-051,602318 136893,,Katherine Parker,heidi24@gmail.com,661.045.0976x7538,,Lisa Clark,68280 Swanson Forge,Apartment A,Springfield,OR,97477,United States,US,1/21/20,,United States,US,OR,Springfield,duckduckgo.com,duckduckgo.com/
517,1/20/20 4:09am,Bandcamp,album,Music from Saharan Cellphones,Various,USD,7.0,1.0,,7.0,,,,0.4,paypal,7.0,0.0,1001687374,,0.7,0.7,0.0,5.9,256.58,5.9,digital download,,http://sahelsounds.bandcamp.com/album/music-from-saharan-cellphones,,SS-003,889326 667889,,Connie Mendoza,bakerdean@hotmail.com,786.609.2610,,Hailey Brock,1994 Karla Skyway,,,,,,,,,United States,US,KY,Brandenburg,,
518,1/20/20 5:14am,Bandcamp,album,Music from Saharan WhatsApp,Etran de L'Aïr,USD,2.0,1.0,,2.0,,,,0.15,credit card,2.0,0.0,1527141814,,0.2,0.2,0.0,1.65,258.23,1.65,digital download,,http://etrandelair.bandcamp.com/album/music-from-saharan-whatsapp,,WHATSAPP-01,,,Calvin Jackson,erica47@harris-steele.org,001-591-749-0413,,Jamie Brown,01665 Sims Common Apt. 998,,,,,,,,,United States,US,CA,San Francisco,Bandcamp New & Notable,bandcamp.com/#new-notable
519,1/20/20 5:44am,Bandcamp,album,Music from Saharan Cellphones,Various,USD,7.0,1.0,,7.0,,,,0.4,paypal,7.0,0.0,201765391,,0.7,0.7,0.0,5.9,264.13,5.9,digital download,,http://sahelsounds.bandcamp.com/album/music-from-saharan-cellphones,,SS-003,889326 667889,,Carlos Sanford,paul69@yahoo.com,+1-332-461-9757x38581,,Anita Newman,620 Michelle Lock,,,,,,,,,United States,US,CA,Santa Clara,,
520,1/20/20 8:42am,Bandcamp,album,Music from Saharan WhatsApp,Etran de L'Aïr,USD,3.0,1.0,,3.0,,,,0.23,paypal,3.0,0.0,2002405652,,0.3,0.3,0.0,2.47,266.6,2.47,digital download,,http://etrandelair.bandcamp.com/album/music-from-saharan-whatsapp,,WHATSAPP-01,,,Susan Zimmerman,kristin19@yahoo.com,(701)260-1191,,Raymond Hoover,72219 Foster Isle,,,,,,,,,United Kingdom,GB,Bristol,Bristol,,
521,1/20/20 4:24pm,Bandcamp,album,Music from Saharan WhatsApp,Etran de L'Aïr,USD,1.0,1.0,,1.0,,,,0.11,paypal,1.0,0.0,2708024795,,0.1,0.1,0.0,0.79,267.39,0.79,digital download,,http://etrandelair.bandcamp.com/album/music-from-saharan-whatsapp,,WHATSAPP-01,,,Jermaine Reed,blairtracey@yahoo.com,(083)431-4343,,Jessica Chaney,85764 Lisa Pine Suite 791,,,,,,,,,Ireland,IE,Leinster,Dublin,Bandcamp fan wishlist,bandcamp.com/adrianconstable
522,1/20/20 4:25pm,Bandcamp,album,Les Filles de Illighadad,Les Filles de Illighadad,USD,7.0,1.0,,7.0,1.61,,,0.58,credit card,8.61,0.0,4007502752,,0.7,0.7,0.0,5.72,273.11,5.72,digital download,,http://lesfillesdeillighadad.bandcamp.com/album/les-filles-de-illighadad,,SS-033,889326 664918,,Robert Diaz,mckaystephen@hotmail.com,(784)318-8040x002,,Michael Webster,5374 Bridges Forks Suite 074,,,,,,,,,Ireland,IE,County Carlow,Carlow,Google search,www.google.com/
523,1/20/20 5:41pm,Bandcamp,album,Music from Saharan WhatsApp,Etran de L'Aïr,USD,1.3,1.0,,1.3,,,,0.13,paypal,1.3,0.0,49135189,,0.13,0.13,0.0,1.04,274.15,1.04,digital download,,http://etrandelair.bandcamp.com/album/music-from-saharan-whatsapp,,WHATSAPP-01,,,Joy Harris,sanfordjanet@hotmail.com,781-391-2776x69442,,Christopher Johnson,6545 James Cove Apt. 870,,,,,,,,,United Kingdom,GB,Sheffield,Sheffield,Bandcamp fan page: ethann__smith,bandcamp.com/ethann__smith/wishlist
524,1/20/20 5:53pm,Bandcamp,album,Music from Saharan WhatsApp,Etran de L'Aïr,USD,3.0,1.0,,3.0,,,,0.2,paypal,3.0,0.0,359676804,,0.3,0.3,0.0,2.5,276.65,2.5,digital download,,http://etrandelair.bandcamp.com/album/music-from-saharan-whatsapp,,WHATSAPP-01,,,Amanda Mcintyre,washingtondarren@rojas-williams.biz,+1-604-956-7158,,Katie Walton,460 Keith Avenue,,,,,,,,,United States,US,CO,Colorado Springs,Bandcamp search,bandcamp.com/autocomplete-search
525,1/20/20 6:02pm,shop@sahelsounds.com,payout,,,USD,,,,,,,,1.33,transfer,133.05,131.72,t252664279,6XF273511P5500939,,,,-133.05,143.6,,,,,,,,,,,,,,,,,,,,,,,,,,,,
526,1/20/20 6:02pm,shop@sahelsounds.com,payout,,,USD,,,,,,,,0.16,transfer,16.38,16.22,t252664278,3DW217516W5933245,,,,-16.38,127.22,,,,,,,,,,,,,,,,,,,,,,,,,,,,
527,1/20/20 7:17pm,Bandcamp,album,Music from Saharan WhatsApp,Etran de L'Aïr,USD,1.0,1.0,,1.0,,,,0.11,paypal,1.0,0.0,59531789,,0.1,0.1,0.0,0.79,128.01,0.79,digital download,,http://etrandelair.bandcamp.com/album/music-from-saharan-whatsapp,,WHATSAPP-01,,,Renee Hobbs,ashleyhernandez@bennett.net,(115)186-5357,,Rhonda Bailey,751 Jennifer Light,,,,,,,,,Belgium,BE,West Flanders Province,Kortrijk,Publish notice sent to your fans,
528,1/20/20 7:21pm,Bandcamp,album,Music from Saharan WhatsApp,Etran de L'Aïr,USD,3.0,1.0,,3.0,,,,0.2,gift card,3.0,0.0,3942437132,,0.3,0.3,0.0,2.5,130.51,2.5,digital download,,http://etrandelair.bandcamp.com/album/music-from-saharan-whatsapp,,WHATSAPP-01,,,Amy Riley,john33@patterson-wilson.org,667.075.3138,,Erika Novak,15618 Patrick Drive,,,,,,,,,United States,US,NY,Sunnyside,Bandcamp: thomasmartin19/following/artists_and_labels,bandcamp.com/thomasmartin19/following/artists_and_labels
529,1/20/20 8:14pm,Bandcamp,album,Music from Saharan WhatsApp,Etran de L'Aïr,USD,1.0,1.0,,1.0,,,,0.1,credit card,1.0,0.0,3186883997,,0.1,0.1,0.0,0.8,131.31,0.8,digital download,,http://etrandelair.bandcamp.com/album/music-from-saharan-whatsapp,,WHATSAPP-01,,,Nicole Mccarthy,robertsonwendy@yahoo.com,9950018916,,Krystal Horton,67835 Joseph Square,,,,,,,,,United States,US,CA,Los Angeles,Bandcamp Discover,bandcamp.com/#discover
530,1/20/20 8:24pm,Bandcamp,album,Music from Saharan WhatsApp,Etran de L'Aïr,USD,2.0,1.0,,2.0,,,,0.17,paypal,2.0,0.0,363484471,,0.2,0.2,0.0,1.63,132.94,1.63,digital download,,http://etrandelair.bandcamp.com/album/music-from-saharan-whatsapp,,WHATSAPP-01,,,Jennifer Martinez,robin07@chaney.com,292.472.2073x010,,Debra Robinson,1518 Brooke River,,,,,,,,,United Kingdom,GB,,,Bandcamp music feed,http://blog.bandcamp.com/2014/01/30/bandcamp-app-now-with-music-feed/
531,1/20/20 9:06pm,Bandcamp,album,Music from Saharan WhatsApp,Etran de L'Aïr,USD,3.0,1.0,,3.0,,,,0.2,credit card,3.0,0.0,2871909099,,0.3,0.3,0.0,2.5,135.44,2.5,digital download,,http://etrandelair.bandcamp.com/album/music-from-saharan-whatsapp,,WHATSAPP-01,,,Edward Franklin,ehanson@scott.net,001-716-042-6955x62542,,Carla Kennedy,37121 Michelle Prairie Suite 337,,,,,,,,,United States,US,CA,San Jose,Publish notice sent to your fans,
532,1/20/20 9:21pm,Bandcamp,album,Music from Saharan WhatsApp,Etran de L'Aïr,USD,5.0,1.0,,5.0,,,,0.3,credit card,5.0,0.0,714252370,,0.5,0.5,0.0,4.2,139.64,4.2,digital download,,http://etrandelair.bandcamp.com/album/music-from-saharan-whatsapp,,WHATSAPP-01,,,Susan Wood,jack59@shaw.info,(038)510-2933,,Sarah Stevens,4309 Jacqueline Court,,,,,,,,,United States,US,CA,Hayward,,
533,1/20/20 10:11pm,Bandcamp,package,Ilana: The Creator,Mdou Moctar,USD,17.0,1.0,,17.0,,5.0,United States,0.78,credit card,22.0,0.0,3243437546,,1.7,1.7,0.0,19.52,159.16,14.52,Ilana LP,,http://mdoumoctar.bandcamp.com/album/ilana-the-creator,SS-051lp,SS-051,602318 136893,,John Hughes,andersonjesse@harris.com,001-015-546-8113,,Bradley Nguyen,27140 Farley Divide,,Fish Creek,WI,54212,United States,US,1/21/20,,United States,US,WI,Fish Creek,Bandcamp search: “mdou moctar”,bandcamp.com/search?q=mdou%20moctar
534,1/20/20 10:19pm,Bandcamp,album,Music from Saharan WhatsApp,Etran de L'Aïr,USD,1.0,1.0,,1.0,,,,0.1,credit card,1.0,0.0,4178026366,,0.1,0.1,0.0,0.8,159.96,0.8,digital download,,http://etrandelair.bandcamp.com/album/music-from-saharan-whatsapp,,WHATSAPP-01,,,Jeffery Jordan,blevinsmiguel@smith.com,001-162-604-3364x88174,,Megan Lane,19459 Johnson Manors,,,,,,,,,United States,US,CA,Los Angeles,,
535,1/20/20 11:20pm,Bandcamp,album,Music from Saharan WhatsApp,Etran de L'Aïr,USD,2.0,1.0,,2.0,,,,0.15,paypal,2.0,0.0,3885436636,,0.2,0.2,0.0,1.65,161.61,1.65,digital download,,http://etrandelair.bandcamp.com/album/music-from-saharan-whatsapp,,WHATSAPP-01,,,David Freeman,ellisdanny@alexander.com,(815)835-4772x536,,Donna Carpenter,6052 Pittman Bridge Suite 518,,,,,,,,,United States,US,MO,St Louis,,
536,1/21/20 12:48am,Bandcamp,album,Music from Saharan WhatsApp,Etran de L'Aïr,USD,5.0,1.0,,5.0,,,,0.3,paypal,5.0,0.0,2591916513,,0.5,0.5,0.0,4.2,165.81,4.2,digital download,,http://etrandelair.bandcamp.com/album/music-from-saharan-whatsapp,,WHATSAPP-01,,,Jeffrey Riddle,pattonlaura@gmail.com,577-575-8203,,Benjamin Davis,60351 Matthew Overpass Suite 327,,,,,,,,,United States,US,CA,San Francisco,Bandcamp weekly newsletter,bandcamp.com
537,1/21/20 2:17am,Bandcamp,package,Eghass Malan,Les Filles de Illighadad,USD,17.0,1.0,,17.0,,5.0,United States,1.08,paypal,22.0,0.0,3127716276,,1.7,0.0,1.7,0.0,165.81,14.22,'Eghass Malan' LP,,http://lesfillesdeillighadad.bandcamp.com/album/eghass-malan,SS-044lp-1,SS-044,191515 928351,,Christine Murphy,williamsbrittany@gmail.com,(030)135-8433x31773,,Tina Newman,78243 Noble Forest,,chicago,IL,60622,United States,US,1/21/20,,United States,US,IL,chicago,youtube.com,www.youtube.com/
538,1/21/20 2:17am,Bandcamp,package,Les Filles de Illighadad,Les Filles de Illighadad,USD,17.0,1.0,,17.0,,2.0,United States,,,19.0,0.0,3127716276,,1.7,3.4,0.0,36.52,202.33,15.3,Les Filles de Illighadad LP,,http://lesfillesdeillighadad.bandcamp.com/album/les-filles-de-illighadad,SS-033-LP,SS-033,889326 664918,,Kevin Phelps,mark41@conley.net,200-573-9684,,Paula Cochran,789 Barry Dam Apt. 989,,chicago,IL,60622,United States,US,1/21/20,,United States,US,IL,chicago,youtube.com,www.youtube.com/
539,1/21/20 5:44am,Bandcamp,album,Music from Saharan WhatsApp,Etran de L'Aïr,USD,1.0,1.0,,1.0,,,,0.1,paypal,1.0,0.0,1423725623,,0.1,0.1,0.0,0.8,203.13,0.8,digital download,,http://etrandelair.bandcamp.com/album/music-from-saharan-whatsapp,,WHATSAPP-01,,,Donald Douglas,qcurry@guerrero-chapman.info,(673)393-0902x04213,,Caitlin Cox,9789 Phillips Vista Apt. 003,,,,,,,,,United States,US,MD,Towson,Bandcamp music feed,http://blog.bandcamp.com/2014/01/30/bandcamp-app-now-with-music-feed/
540,1/21/20 7:32am,Bandcamp,album,Music from Saharan WhatsApp,Etran de L'Aïr,USD,5.0,1.0,,5.0,,,,0.35,credit card,5.0,0.0,4193897684,,0.5,0.5,0.0,4.15,207.28,4.15,digital download,,http://etrandelair.bandcamp.com/album/music-from-saharan-whatsapp,,WHATSAPP-01,,,Richard Mccoy,theresa68@hotmail.com,+1-364-744-5926x174,,Jennifer Bond,529 Webb Views,,,,,,,,,Canada,CA,BC,Vancouver,,
541,1/21/20 8:48am,Bandcamp,album,Music from Saharan WhatsApp,Etran de L'Aïr,USD,1.0,1.0,,1.0,,,,0.11,credit card,1.0,0.0,1442005975,,0.1,0.1,0.0,0.79,208.07,0.79,digital download,,http://etrandelair.bandcamp.com/album/music-from-saharan-whatsapp,,WHATSAPP-01,,,Michael Myers,sanchezdennis@gmail.com,728.998.5894x57413,,Linda Davis,017 Howard Pines Apt. 698,,,,,,,,,United Kingdom,GB,England,London,,
542,1/21/20 12:19pm,Bandcamp,album,Waande Kadde,Amadou Binta Konté and Tidiane Thiam,USD,10.0,1.0,,10.0,,,,0.49,paypal,10.0,0.0,3271301894,,1.0,1.0,0.0,8.51,216.58,8.51,digital download,,http://sahelsounds.bandcamp.com/album/waande-kadde,,SS-036 / SFH-01,889326 796008,,Christopher Stewart,clarkwilliam@gmail.com,310.375.3361x86519,,Daniel Kirby,8749 Torres Corner,,,,,,,,,United States,US,PA,Philadelphia,,
543,1/21/20 2:23pm,Bandcamp,album,Music from Saharan Cellphones,Various,USD,10.0,1.0,,10.0,,,,0.49,paypal,10.0,0.0,3506430162,,1.0,1.0,0.0,8.51,225.09,8.51,digital download,,http://sahelsounds.bandcamp.com/album/music-from-saharan-cellphones,,SS-003,889326 667889,,Carl Aguilar,james56@yahoo.com,980-458-2973x6120,,Alisha Ramirez,511 Patricia Extensions,,,,,,,,,United States,US,NH,Lebanon,messages.google.com,messages.google.com/web/conversations/35?redirected=true
544,1/21/20 5:36pm,Bandcamp,track,Anou Malane,Abdallah Ag Oumbadougou,USD,1.0,1.0,,1.0,0.2,,,0.12,paypal,1.2,0.0,3091553507,,0.1,0.1,0.0,0.78,225.87,0.78,digital download,,http://abdallahagoumbadougou.bandcamp.com/track/anou-malane,,SS-053,,,Miranda Baker,heather61@davis-carter.com,+1-653-469-4151x7410,,Brett Coleman,12943 Michelle Vista,,,,,,,,,United Kingdom,GB,West Sussex,Henfield,Bandcamp fan page: techsupportrecordings,bandcamp.com/techsupportrecordings/wishlist
545,1/21/20 6:02pm,shop@sahelsounds.com,payout,,,USD,,,,,,,,0.39,transfer,38.97,38.58,t252885641,4K179807AG588520J,,,,-38.97,186.9,,,,,,,,,,,,,,,,,,,,,,,,,,,,
546,1/21/20 6:03pm,shop@sahelsounds.com,payout,,,USD,,,,,,,,0.88,transfer,88.25,87.37,t252885640,5X310201216667849,,,,-88.25,98.65,,,,,,,,,,,,,,,,,,,,,,,,,,,,
547,1/21/20 6:22pm,Bandcamp,album,Music from Saharan WhatsApp,Etran de L'Aïr,USD,3.56,1.0,,3.56,,,,0.26,paypal,3.56,0.0,1085116256,,0.36,0.36,0.0,2.94,101.59,2.94,digital download,,http://etrandelair.bandcamp.com/album/music-from-saharan-whatsapp,,WHATSAPP-01,,,Kimberly Garcia,smithmichelle@turner-watson.com,4782406947,,Patrick Ross,9247 Hunter Passage Apt. 520,,,,,,,,,Brazil,BR,Federal District,Brasília,Bandcamp music feed,http://blog.bandcamp.com/2014/01/30/bandcamp-app-now-with-music-feed/
548,1/21/20 7:47pm,Bandcamp,album,Music from Saharan WhatsApp,Etran de L'Aïr,USD,4.0,1.0,,4.0,,,,0.29,credit card,4.0,0.0,1155617562,,0.4,0.4,0.0,3.31,104.9,3.31,digital download,,http://etrandelair.bandcamp.com/album/music-from-saharan-whatsapp,,WHATSAPP-01,,,Michael Blevins,heatherwarren@gmail.com,(787)577-9807x809,,Leonard Stevens,815 Wade Mission,,,,,,,,,United Kingdom,GB,Birmingham,Birmingham,Bandcamp fan page: ptb,bandcamp.com/ptb
549,1/21/20 7:51pm,Bandcamp,album,Music from Saharan WhatsApp,Etran de L'Aïr,USD,3.0,1.0,,3.0,,,,0.23,paypal,3.0,0.0,2510452329,,0.3,0.3,0.0,2.47,107.37,2.47,digital download,,http://etrandelair.bandcamp.com/album/music-from-saharan-whatsapp,,WHATSAPP-01,,,Tiffany Trevino,emartinez@smith-mann.com,001-053-080-6199x1790,,Mark Osborn,5512 Mary Plaza,,,,,,,,,France,FR,Maine-et-Loire,Le Lion-dAngers,,
550,1/21/20 8:39pm,Bandcamp,album,Music from Saharan WhatsApp,Etran de L'Aïr,USD,5.0,1.0,,5.0,,,,0.3,paypal,5.0,0.0,2774561367,,0.5,0.5,0.0,4.2,111.57,4.2,digital download,,http://etrandelair.bandcamp.com/album/music-from-saharan-whatsapp,,WHATSAPP-01,,,Logan Jones,zhall@jennings-mason.com,001-751-244-8000x7944,,Lynn Garcia,369 Dawn Tunnel,,,,,,,,,United States,US,NY,Brooklyn,,
551,1/21/20 9:14pm,Bandcamp,album,Music from Saharan WhatsApp,Etran de L'Aïr,USD,10.0,1.0,,10.0,,,,0.59,paypal,10.0,0.0,2516435125,,1.0,1.0,0.0,8.41,119.98,8.41,digital download,,http://etrandelair.bandcamp.com/album/music-from-saharan-whatsapp,,WHATSAPP-01,,,Nancy Mckay,barneseric@peterson-taylor.com,322.515.2017x629,,Logan Waters,4860 Phillips Isle Suite 598,,,,,,,,,Canada,CA,QC,Montreal,Bandcamp search,bandcamp.com/app/android/search
552,1/21/20 9:53pm,Bandcamp,album,Music from Saharan WhatsApp,Etran de L'Aïr,USD,1.0,1.0,,1.0,,,,0.1,paypal,1.0,0.0,1325701351,,0.1,0.1,0.0,0.8,120.78,0.8,digital download,,http://etrandelair.bandcamp.com/album/music-from-saharan-whatsapp,,WHATSAPP-01,,,John Vargas,timothydean@hotmail.com,888-611-5210,,Joseph Bailey,522 Jacqueline Stravenue Apt. 440,,,,,,,,,United States,US,PA,Quakertown,Bandcamp fan page: arctostaphylos,bandcamp.com/arctostaphylos
553,1/21/20 10:36pm,Bandcamp,album,Music from Saharan WhatsApp,Etran de L'Aïr,USD,1.0,1.0,,1.0,,,,0.1,paypal,1.0,0.0,2155972125,,0.1,0.1,0.0,0.8,121.58,0.8,digital download,,http://etrandelair.bandcamp.com/album/music-from-saharan-whatsapp,,WHATSAPP-01,,,Robin Garza,susanfoster@scott.com,366-300-7137,,Christina Travis,3449 Brittany Via,,,,,,,,,United States,US,TX,Austin,Bandcamp fan wishlist,bandcamp.com/shando
554,1/21/20 11:15pm,Bandcamp,package,Akounak Tedalat Taha Tazoughai OST,Mdou Moctar,USD,17.0,1.0,,17.0,,5.0,United States,0.78,credit card,22.0,0.0,3215420242,,1.7,1.7,0.0,19.52,141.1,14.52,Akounak OST LP,,http://mdoumoctar.bandcamp.com/album/akounak-tedalat-taha-tazoughai-ost,SS-028lp-1,SS-028,889326 667599,,Christina Welch,olivia22@yahoo.com,+1-455-175-1766x638,,Maria Jones,547 Duran Valley,,Woburn,MA,1801,United States,US,1/28/20,,United States,US,MA,Woburn,Google search,www.google.com/
555,1/22/20 12:47am,Bandcamp,album,Music from Saharan WhatsApp,Etran de L'Aïr,USD,4.0,1.0,,4.0,,,,0.29,credit card,4.0,0.0,2284670820,,0.4,0.4,0.0,3.31,144.41,3.31,digital download,,http://etrandelair.bandcamp.com/album/music-from-saharan-whatsapp,,WHATSAPP-01,,,Karen Gomez,alexanderrachel@escobar.com,001-316-214-4828,,Natasha Stevens,048 Brian Plains,,,,,,,,,Norway,NO,,Oppegard,Bandcamp search,bandcamp.com/autocomplete-search
556,1/22/20 1:22am,Bandcamp,album,Music from Saharan WhatsApp,Etran de L'Aïr,USD,1.0,1.0,,1.0,,,,0.1,paypal,1.0,0.0,2192876647,,0.1,0.1,0.0,0.8,145.21,0.8,digital download,,http://etrandelair.bandcamp.com/album/music-from-saharan-whatsapp,,WHATSAPP-01,,,Erik French,hessmatthew@murray.com,(250)864-9680x580,,Christina Simmons,4720 Campos Mountains,,,,,,,,,United States,US,AZ,Goodyear,,
557,1/22/20 2:19am,Bandcamp,album,Music from Saharan WhatsApp,Etran de L'Aïr,USD,3.0,1.0,,3.0,,,,0.11,credit card,3.0,0.0,3086407130,,0.3,0.3,0.0,2.59,147.8,2.59,digital download,,http://etrandelair.bandcamp.com/album/music-from-saharan-whatsapp,,WHATSAPP-01,,,Sarah Berger,brent10@hotmail.com,038-360-7178x977,,Parker Richardson,9006 Cooper Mountains Suite 585,,,,,,,,,United States,US,VA,Arlington,Bandcamp: akarsh/following/artists_and_labels,bandcamp.com/akarsh/following/artists_and_labels
558,1/22/20 3:13am,Bandcamp,album,Music from Saharan WhatsApp,Etran de L'Aïr,USD,3.0,1.0,,3.0,,,,0.2,paypal,3.0,0.0,2586069611,,0.3,0.3,0.0,2.5,150.3,2.5,digital download,,http://etrandelair.bandcamp.com/album/music-from-saharan-whatsapp,,WHATSAPP-01,,,Jessica Jones,michaelburke@hotmail.com,432-437-5695x1929,,Rose Williamson,11296 Thomas Path,,,,,,,,,United States,US,IL,Champaign,Google search,www.google.com/
559,1/22/20 3:44am,Bandcamp,package,Falaw,Luka Productions,USD,17.0,1.0,,17.0,,5.0,United States,0.77,credit card,22.0,0.0,4043528733,,1.7,1.7,0.0,19.53,169.83,14.53,Limited Edition Vinyl,,http://lukaproductions.bandcamp.com/album/falaw,SS-052lp,SS-052,602318 136855,,Michael Quinn,danielle36@gmail.com,716.977.2968x9031,,Michelle Hawkins,54951 Nicole Springs,,Arlington,VA,22205,United States,US,1/28/20,,United States,US,VA,Arlington,,
560,1/22/20 4:36am,Bandcamp,album,Music from Saharan Cellphones: Volume 2,Various,USD,7.0,1.0,,7.0,,,,0.4,paypal,7.0,0.0,2594350010,,0.7,0.7,0.0,5.9,175.73,5.9,digital download,,http://sahelsounds.bandcamp.com/album/music-from-saharan-cellphones-volume-2,,SS-012,889326 667742,,Kevin White,kevingomez@gmail.com,(656)750-5575,,Alisha Clark,36185 Jones Groves Apt. 385,,,,,,,,,United States,US,SC,Beaufort,Google search,www.google.com/
561,1/22/20 4:38am,Bandcamp,package,Hali Diallo,Tallawit Timbouctou,USD,17.0,1.0,,17.0,,2.0,United States,2.1,credit card,19.0,0.0,2507950137,,1.7,0.0,1.7,0.0,175.73,13.2,Vinyl LP,,http://tallawit.bandcamp.com/album/hali-diallo,SS-048lp,SS-048,656605 382265,,James Burnett,wendythompson@smith-coleman.com,+1-729-143-7680,,William Bishop,6333 Diane Neck,,Boise,ID,83705,United States,US,1/28/20,,United States,US,ID,Boise,,
562,1/22/20 4:38am,Bandcamp,package,Akounak Tedalat Taha Tazoughai OST,Mdou Moctar,USD,17.0,1.0,,17.0,,2.0,United States,,,19.0,0.0,2507950137,,1.7,0.0,3.4,0.0,175.73,15.3,Akounak OST LP,,http://mdoumoctar.bandcamp.com/album/akounak-tedalat-taha-tazoughai-ost,SS-028lp-1,SS-028,889326 667599,,Allison Tanner,michaelawilliamson@hotmail.com,559-630-3908x89653,,Oscar Ward,82249 Parker Crossroad Apt. 694,,Boise,ID,83705,United States,US,1/28/20,,United States,US,ID,Boise,,
563,1/22/20 4:38am,Bandcamp,package,Afelan,Mdou Moctar,USD,17.0,1.0,,17.0,,2.0,United States,,,19.0,0.0,2507950137,,1.7,0.0,5.1,0.0,175.73,15.3,Afelan LP,,http://mdoumoctar.bandcamp.com/album/afelan,SS-017lp,SS-017,889326 664840,,Jessica Spencer,john38@sanders.biz,001-017-112-6182,,David Tran,855 Cruz Prairie,,Boise,ID,83705,United States,US,1/28/20,,United States,US,ID,Boise,,
564,1/22/20 4:38am,Bandcamp,package,Sahel Sounds Label Sampler,Various Artists,USD,20.0,1.0,,20.0,,5.0,United States,,,25.0,0.0,2507950137,,2.0,7.1,0.0,72.8,248.53,18.0,Sahel Sounds t-shirt,XL,http://sahelsounds.bandcamp.com/merch/sahel-sounds-t-shirt,SS-T01-BLK-UXL,,,,Brittany Tucker,davidbryant@hernandez-baker.com,645.129.9563,,Cassandra Ramirez,51271 Debra Harbor,,Boise,ID,83705,United States,US,1/28/20,,United States,US,ID,Boise,Google search,www.google.com/
565,1/22/20 8:50am,Bandcamp,album,Music from Saharan WhatsApp,Etran de L'Aïr,USD,2.0,1.0,,2.0,,,,0.17,paypal,2.0,0.0,1023229598,,0.2,0.2,0.0,1.63,250.16,1.63,digital download,,http://etrandelair.bandcamp.com/album/music-from-saharan-whatsapp,,WHATSAPP-01,,,Barbara Hughes,hyoung@patel.com,+1-943-260-1207x225,,Tiffany Bartlett,5643 Anderson Ridge Suite 969,,,,,,,,,Poland,PL,Mazovia,Warsaw,Bandcamp search,bandcamp.com/autocomplete-search
566,1/22/20 10:44am,Bandcamp,album,Music from Saharan WhatsApp,Etran de L'Aïr,USD,1.0,1.0,,1.0,,,,0.11,credit card,1.0,0.0,218818822,,0.1,0.1,0.0,0.79,250.95,0.79,digital download,,http://etrandelair.bandcamp.com/album/music-from-saharan-whatsapp,,WHATSAPP-01,,,Tamara Gutierrez,spowell@robinson.com,001-410-210-9478x604,,Sara Barr,4570 Joseph Wall,,,,,,,,,United Kingdom,GB,England,London,,
567,1/22/20 11:22am,Bandcamp,album,Ilana: The Creator,Mdou Moctar,USD,7.0,1.0,,7.0,,,,0.47,paypal,7.0,0.0,1423522268,,0.7,0.7,0.0,5.83,256.78,5.83,digital download,,http://mdoumoctar.bandcamp.com/album/ilana-the-creator,,SS-051,602318 136893,,Michael Dorsey,taragarcia@torres.org,001-032-940-5925x43035,,Carol Morrow,52534 Leslie Plain Apt. 430,,,,,,,,,Australia,AU,QLD,Toowoomba,Bandcamp artist: mdoumoctar,mdoumoctar.bandcamp.com
568,1/22/20 11:38am,Bandcamp,package,Hali Diallo,Tallawit Timbouctou,USD,17.0,1.0,,17.0,,4.0,United States,2.83,paypal,21.0,0.0,3177458495,,1.7,0.0,1.7,0.0,256.78,12.47,Vinyl LP,,http://tallawit.bandcamp.com/album/hali-diallo,SS-048lp,SS-048,656605 382265,,Kimberly King,andreasingh@smith-may.com,(719)669-6740x0166,,Julie Rivera,560 Amy Bridge Suite 172,7-17 LATONA ROAD,LONDON,,SE15 6RY,United Kingdom,GB,1/28/20,,United Kingdom,GB,,LONDON,,
569,1/22/20 11:38am,Bandcamp,package,Ilana: The Creator,Mdou Moctar,USD,17.0,1.0,,17.0,,4.0,United States,,,21.0,0.0,3177458495,,1.7,0.0,3.4,0.0,256.78,15.3,Ilana LP,,http://mdoumoctar.bandcamp.com/album/ilana-the-creator,SS-051lp,SS-051,602318 136893,,Greg Russell,fostersusan@hotmail.com,847.487.4126,,Steven Scott,3129 Garcia Unions Suite 084,7-17 LATONA ROAD,LONDON,,SE15 6RY,United Kingdom,GB,1/28/20,,United Kingdom,GB,,LONDON,,
570,1/22/20 11:38am,Bandcamp,package,Anou Malane,Abdallah Ag Oumbadougou,USD,17.0,1.0,,17.0,,4.0,United States,,,21.0,0.0,3177458495,,1.7,0.0,5.1,0.0,256.78,15.3,Vinyl,,http://abdallahagoumbadougou.bandcamp.com/album/anou-malane,SS-053lp,SS-053,602318 136992,,Christine Stevens,karen92@hotmail.com,936.479.8033,,Mario Shelton,3592 Wilson Mountains,7-17 LATONA ROAD,LONDON,,SE15 6RY,United Kingdom,GB,1/28/20,,United Kingdom,GB,,LONDON,,
571,1/22/20 11:38am,Bandcamp,package,Houmeissa,Hama,USD,17.0,1.0,,17.0,,4.0,United States,,,21.0,0.0,3177458495,,1.7,0.0,6.8,0.0,256.78,15.3,Hama - Houmeissa LP,,http://hamasynth.bandcamp.com/album/houmeissa,SS-049lp,SS-049,656605 382364,,Jose Hudson,jeffreyreyes@gmail.com,+1-154-265-9177x5758,,Samantha Collins,03251 Marvin Street,7-17 LATONA ROAD,LONDON,,SE15 6RY,United Kingdom,GB,1/28/20,,United Kingdom,GB,,LONDON,,
572,1/22/20 11:38am,Bandcamp,package,Falaw,Luka Productions,USD,17.0,1.0,,17.0,,24.0,United States,,,41.0,0.0,3177458495,,1.7,0.0,8.5,0.0,256.78,15.3,Limited Edition Vinyl,,http://lukaproductions.bandcamp.com/album/falaw,SS-052lp,SS-052,602318 136855,,Jonathan Chaney,lauren55@mcneil-martin.com,+1-142-892-9052x98937,,Matthew Miller,12875 Smith Greens Suite 918,7-17 LATONA ROAD,LONDON,,SE15 6RY,United Kingdom,GB,1/28/20,,United Kingdom,GB,,LONDON,,
573,1/22/20 11:38am,Bandcamp,album,Terrouzi,Ahmedou Ahmed Lowla,USD,7.0,1.0,,7.0,1.4,,,,,8.4,0.0,3177458495,,0.7,9.2,0.0,119.97,376.75,6.3,digital download,,http://ahmedouahmedlowla.bandcamp.com/album/terrouzi,,SS-054,602318 137029,,Andrea Martin,trobinson@dawson.org,664-617-2519,,Jennifer Gallagher,2004 Tina Divide,7-17 LATONA ROAD,LONDON,,SE15 6RY,,,,,United Kingdom,GB,Lewisham,,,
574,1/22/20 11:40am,Bandcamp,package,Tiris,El Wali,USD,17.0,1.0,,17.0,,23.0,United States,1.46,paypal,40.0,0.0,527675404,,1.7,1.7,0.0,36.84,413.59,13.84,Tiris LP,,http://elwali.bandcamp.com/album/tiris,SS-055lp,SS-055,602318 136923,,Patricia Hill,bakerdouglas@ortiz.com,539.045.2136,,Lisa Hernandez,7448 Johnson Oval Suite 688,,Ingleburn,NSW,2565,Australia,AU,1/28/20,,Australia,AU,NSW,Ingleburn,youtube.com,www.youtube.com/
575,1/22/20 1:36pm,Bandcamp,album,Music from Saharan WhatsApp,Etran de L'Aïr,USD,3.0,1.0,,3.0,,,,0.2,paypal,3.0,0.0,1889354421,,0.3,0.3,0.0,2.5,416.09,2.5,digital download,,http://etrandelair.bandcamp.com/album/music-from-saharan-whatsapp,,WHATSAPP-01,,,April Mills,ricky16@arnold-rubio.info,+1-200-530-1946x636,,Briana Sullivan,7268 Lee Pines,,,,,,,,,United States,US,PA,Sellersville,,
576,1/22/20 1:38pm,Bandcamp,album,Music from Saharan WhatsApp,Etran de L'Aïr,USD,1.0,1.0,,1.0,,,,0.11,credit card,1.0,0.0,3768609287,,0.1,0.1,0.0,0.79,416.88,0.79,digital download,,http://etrandelair.bandcamp.com/album/music-from-saharan-whatsapp,,WHATSAPP-01,,,Steven Powell,gbell@yahoo.com,+1-207-353-5381x431,,Regina Torres,079 Jennifer Lodge,,,,,,,,,Poland,PL,Lublin,Poniatowa,Bandcamp fan page: wujekb,bandcamp.com/wujekb
577,1/22/20 3:42pm,Bandcamp,album,Tiris,El Wali,USD,7.0,1.0,,7.0,1.33,,,0.69,paypal,8.33,0.0,1702118465,,0.7,0.0,0.7,0.0,416.88,5.61,digital download,,http://elwali.bandcamp.com/album/tiris,,SS-055,602318 136923,,David Garcia,jay46@richards.org,(691)860-3707x320,,Kimberly James,3761 Mark Mill,,,,,,,,,Germany,DE,Lower Saxony,Zeven,,
578,1/22/20 3:42pm,Bandcamp,album,Music from Saharan WhatsApp,Etran de L'Aïr,USD,5.0,1.0,,5.0,,,,,,5.0,0.0,1702118465,,0.5,1.2,0.0,10.11,426.99,4.5,digital download,,http://etrandelair.bandcamp.com/album/music-from-saharan-whatsapp,,WHATSAPP-01,,,Rodney Grant,devin82@wilkinson-vargas.com,+1-504-855-1679x676,,Ricky Smith,20752 David Gateway,,,,,,,,,Germany,DE,Lower Saxony,Zeven,,
579,1/22/20 4:57pm,Bandcamp,album,Music from Saharan WhatsApp,Etran de L'Aïr,USD,1.0,1.0,,1.0,,,,0.1,paypal,1.0,0.0,4107928836,,0.1,0.1,0.0,0.8,427.79,0.8,digital download,,http://etrandelair.bandcamp.com/album/music-from-saharan-whatsapp,,WHATSAPP-01,,,Megan Jones,erichamilton@hotmail.com,521.830.5126x648,,Robert Harding,245 Price Underpass,,,,,,,,,United States,US,NY,Wappingers Falls,Bandcamp weekly newsletter,bandcamp.com
580,1/22/20 5:09pm,Bandcamp,album,Music from Saharan WhatsApp,Etran de L'Aïr,USD,3.0,1.0,,3.0,,,,0.2,paypal,3.0,0.0,661862253,,0.3,0.3,0.0,2.5,430.29,2.5,digital download,,http://etrandelair.bandcamp.com/album/music-from-saharan-whatsapp,,WHATSAPP-01,,,James Carson,christopher42@hotmail.com,789.505.0674x571,,Garrett Anderson,9843 Adam River Suite 239,,,,,,,,,United States,US,OH,Cleveland,,
581,1/22/20 6:02pm,shop@sahelsounds.com,payout,,,USD,,,,,,,,0.76,transfer,75.56,74.8,t253108773,9W338513YY325393P,,,,-75.56,354.73,,,,,,,,,,,,,,,,,,,,,,,,,,,,
582,1/22/20 6:03pm,shop@sahelsounds.com,payout,,,USD,,,,,,,,0.23,transfer,23.09,22.86,t253108775,3LE49266GC783240B,,,,-23.09,331.64,,,,,,,,,,,,,,,,,,,,,,,,,,,,
583,1/22/20 6:43pm,Bandcamp,album,Music from Saharan WhatsApp,Etran de L'Aïr,USD,5.0,1.0,,5.0,,,,0.3,paypal,5.0,0.0,639674689,,0.5,0.5,0.0,4.2,335.84,4.2,digital download,,http://etrandelair.bandcamp.com/album/music-from-saharan-whatsapp,,WHATSAPP-01,,,Joshua Green,beckjoshua@gmail.com,001-693-475-8606,,George Flores,9894 Mueller Cape Apt. 427,,,,,,,,,United States,US,KY,Lexington,Bandcamp search,bandcamp.com/app/ios/search
584,1/22/20 6:49pm,Bandcamp,album,Music from Saharan WhatsApp,Etran de L'Aïr,USD,10.0,1.0,,10.0,,,,0.59,paypal,10.0,0.0,1159485497,,1.0,1.0,0.0,8.41,344.25,8.41,digital download,,http://etrandelair.bandcamp.com/album/music-from-saharan-whatsapp,,WHATSAPP-01,,,John Bush,adrianaenglish@blake.info,396.035.3630,,Jesse Smith,198 Dominguez Summit Suite 094,,,,,,,,,Mexico,MX,Mexico City,Mexico City,Publish notice sent to your fans,
585,1/22/20 7:47pm,Bandcamp,album,Music from Saharan WhatsApp,Etran de L'Aïr,USD,7.0,1.0,,7.0,,,,0.47,credit card,7.0,0.0,963178426,,0.7,0.7,0.0,5.83,350.08,5.83,digital download,,http://etrandelair.bandcamp.com/album/music-from-saharan-whatsapp,,WHATSAPP-01,,,Eric Williams,joel13@hotmail.com,+1-887-163-2967x9119,,Natasha Beck,5970 Smith Curve,,,,,,,,,United Kingdom,GB,Peterborough,Peterborough,Bandcamp search,bandcamp.com/app/android/search
586,1/22/20 11:38pm,Bandcamp,album,Music from Saharan WhatsApp,Etran de L'Aïr,USD,5.0,1.0,,5.0,,,,0.35,paypal,5.0,0.0,1040204633,,0.5,0.5,0.0,4.15,354.23,4.15,digital download,,http://etrandelair.bandcamp.com/album/music-from-saharan-whatsapp,,WHATSAPP-01,,,Yolanda Wilson,monique64@gmail.com,+1-847-950-7950x83316,,Danielle Nelson,601 Alexandria Lock Apt. 819,,,,,,,,,Canada,CA,ON,Toronto,,
587,1/23/20 12:13am,Bandcamp,album,Music from Saharan WhatsApp,Etran de L'Aïr,USD,10.0,1.0,,10.0,,,,0.49,paypal,10.0,0.0,2687052450,,1.0,1.0,0.0,8.51,362.74,8.51,digital download,,http://etrandelair.bandcamp.com/album/music-from-saharan-whatsapp,,WHATSAPP-01,,,Brandon Jones,amy06@gmail.com,(632)186-1238,,Sophia Brown,5742 Holder Lane Suite 173,,,,,,,,,United States,US,OH,Cleveland,,
588,1/23/20 1:40am,Bandcamp,album,Music from Saharan WhatsApp,Etran de L'Aïr,USD,4.0,1.0,,4.0,,,,0.25,paypal,4.0,0.0,83388263,,0.4,0.4,0.0,3.35,366.09,3.35,digital download,,http://etrandelair.bandcamp.com/album/music-from-saharan-whatsapp,,WHATSAPP-01,,,Crystal Smith,torresjesus@yahoo.com,175.628.6953x80714,,Anna Herrera,8630 David Manors,,,,,,,,,United States,US,,,,
589,1/23/20 8:47am,Bandcamp,album,Eghass Malan,Les Filles de Illighadad,USD,7.0,1.0,,7.0,,,,0.47,credit card,7.0,0.0,181784276,,0.7,0.7,0.0,5.83,371.92,5.83,digital download,,http://lesfillesdeillighadad.bandcamp.com/album/eghass-malan,,SS-044,191515 928351,,Robert Mendoza,anthonyanderson@hotmail.com,(549)928-8645x46968,,John Hale,38632 Simmons Islands Apt. 419,,,,,,,,,Congo (Kinshasa),CD,Kinshasa City,Kinshasa,Bandcamp Daily: les-filles-de-illighadad-eghass-malan-review,daily.bandcamp.com/album-of-the-day/les-filles-de-illighadad-eghass-malan-review
590,1/23/20 11:47am,Bandcamp,album,Music from Saharan WhatsApp,Etran de L'Aïr,USD,1.0,1.0,,1.0,,,,0.1,paypal,1.0,0.0,2579675967,,0.1,0.1,0.0,0.8,372.72,0.8,digital download,,http://etrandelair.bandcamp.com/album/music-from-saharan-whatsapp,,WHATSAPP-01,,,Susan Ford,fredkrause@may.com,001-509-113-5963,,Michael Reyes,0329 Barker Vista,,,,,,,,,United States,US,NY,Rhinebeck,Bandcamp search,bandcamp.com/autocomplete-search
591,1/23/20 6:03pm,shop@sahelsounds.com,payout,,,USD,,,,,,,,2.87,transfer,287.18,284.31,t253339911,8UK18634SP554914J,,,,-287.18,85.54,,,,,,,,,,,,,,,,,,,,,,,,,,,,
592,1/23/20 6:03pm,shop@sahelsounds.com,payout,,,USD,,,,,,,,0.44,transfer,44.46,44.02,t253339915,3JY56888855579434,,,,-44.46,41.08,,,,,,,,,,,,,,,,,,,,,,,,,,,,
593,1/23/20 7:20pm,Bandcamp,album,Music from Saharan WhatsApp,Etran de L'Aïr,USD,2.0,1.0,,2.0,,,,0.17,paypal,2.0,0.0,663518989,,0.2,0.2,0.0,1.63,42.71,1.63,digital download,,http://etrandelair.bandcamp.com/album/music-from-saharan-whatsapp,,WHATSAPP-01,,,Kevin Miller,emelendez@yahoo.com,419.658.4618,,Max Sherman,778 Blake Harbors Apt. 848,,,,,,,,,Germany,DE,North Rhine-Westphalia,Furth,Bandcamp music feed,http://blog.bandcamp.com/2013/09/19/strap-on-your-feed-bag/
594,1/23/20 7:21pm,Bandcamp,album,Ilana: The Creator,Mdou Moctar,USD,7.0,1.0,,7.0,1.47,,,0.57,credit card,8.47,0.0,3618707,,0.7,0.7,0.0,5.73,48.44,5.73,digital download,,http://mdoumoctar.bandcamp.com/album/ilana-the-creator,,SS-051,602318 136893,,Clifford Alvarez,rosalesbrittany@meyer.com,001-592-734-3455x951,,Courtney Cox,78377 Evans Throughway,,,,,,,,,Belgium,BE,Liège Province,Herstal,Bandcamp search: “modou moctar”,bandcamp.com/search?q=modou%20moctar
595,1/23/20 8:05pm,Bandcamp,album,Agrim Agadez,Various,USD,7.0,1.0,,7.0,,,,0.4,credit card,7.0,0.0,823528655,,0.7,0.7,0.0,5.9,54.34,5.9,digital download,,http://sahelsounds.bandcamp.com/album/agrim-agadez,,SS-038,889326 872382,,Michael Winters,osmith@gmail.com,500.869.1752x155,,Mark Palmer,762 Reeves Harbors Suite 883,,,,,,,,,United States,US,CA,Costa Mesa,sahelsounds.com (embedded player),sahelsounds.com/2017/01/agrim-agadez/
596,1/23/20 11:25pm,Bandcamp,album,Ilana: The Creator,Mdou Moctar,USD,10.0,1.0,,10.0,,,,0.88,paypal,10.0,0.0,2764929271,,1.0,0.0,1.0,0.0,54.34,8.12,digital download,,http://mdoumoctar.bandcamp.com/album/ilana-the-creator,,SS-051,602318 136893,,Linda Reyes,ryanrodriguez@perkins-brown.com,+1-519-973-1713x916,"I randomly found and heard your music, Mdou and was captivated. So here I am... Extending that pleasure, that joy!  Thanks for your music!",Michael Hartman,8775 Spencer Ramp,,,,,,,,,Chile,CL,Santiago Metropolitan,Las Condes,Bandcamp artist: mdoumoctar,mdoumoctar.bandcamp.com
597,1/23/20 11:25pm,Bandcamp,album,Sousoume Tamachek,Mdou Moctar,USD,10.0,1.0,,10.0,,,,,,10.0,0.0,2764929271,,1.0,2.0,0.0,17.12,71.46,9.0,digital download,,http://mdoumoctar.bandcamp.com/album/sousoume-tamachek,,SS-043,191515 769435,,Andrea Miller,brianturner@hotmail.com,998-018-7969,,David Sullivan,84516 Smith Tunnel,,,,,,,,,Chile,CL,Santiago Metropolitan,Las Condes,Bandcamp artist: mdoumoctar,mdoumoctar.bandcamp.com
598,1/23/20 11:41pm,Bandcamp,album,Eghass Malan,Les Filles de Illighadad,USD,7.0,1.0,,7.0,1.61,,,0.55,paypal,8.61,0.0,1235251185,,0.7,0.7,0.0,5.75,77.21,5.75,digital download,,http://lesfillesdeillighadad.bandcamp.com/album/eghass-malan,,SS-044,191515 928351,,Richard Miller,klopez@goodwin.com,525.532.1130x603,,Ashley Camacho,3380 Bradley Unions,,,,,,,,,Ireland,IE,County Tipperary,Clonmel,,
599,1/24/20 12:07am,Bandcamp,album,Music from Saharan WhatsApp,Etran de L'Aïr,USD,5.0,1.0,,5.0,,,,0.35,paypal,5.0,0.0,2154926703,,0.5,0.5,0.0,4.15,81.36,4.15,digital download,,http://etrandelair.bandcamp.com/album/music-from-saharan-whatsapp,,WHATSAPP-01,,,Brandon Lindsey,stevensdonald@morgan.com,+1-544-558-9027x40373,,Stephanie Durham,641 Thomas Squares,,,,,,,,,United Kingdom,GB,Swindon,Swindon,Bandcamp home page,bandcamp.com/
600,1/24/20 3:36am,Bandcamp,album,Hali Diallo,Tallawit Timbouctou,USD,7.0,1.0,,7.0,,,,0.47,credit card,7.0,0.0,1439218082,,0.7,0.7,0.0,5.83,87.19,5.83,digital download,,http://tallawit.bandcamp.com/album/hali-diallo,,SS-048,656605 382265,,Cameron Mejia,dyerjonathon@yahoo.com,(312)779-3423x706,,Brittany Green,4073 David Mews Suite 556,,,,,,,,,Australia,AU,NSW,Newtown,Bandcamp fan page: stuart_buchanan,bandcamp.com/stuart_buchanan
601,1/24/20 8:19am,Bandcamp,album,Balani Show Super Hits: Electronic Street Parties from Mali,Various,USD,8.0,1.0,,8.0,1.4,,,0.57,paypal,9.4,0.0,730454615,,0.8,0.8,0.0,6.63,93.82,6.63,digital download,,http://sahelsounds.bandcamp.com/album/balani-show-super-hits-electronic-street-parties-from-mali,,SS-021,889326 667643,,Roger Richmond,leepeter@hotmail.com,779.917.0318,,Carla Rodriguez,81262 James Mission Apt. 283,,,,,,,,,France,FR,Paris,Paris,Bandcamp search: “kaba blon”,bandcamp.com/search?q=kaba%20blon
602,1/24/20 11:46am,Bandcamp,album,Music from Saharan WhatsApp,Etran de L'Aïr,USD,3.0,1.0,,3.0,,,,0.23,credit card,3.0,0.0,2286333833,,0.3,0.3,0.0,2.47,96.29,2.47,digital download,,http://etrandelair.bandcamp.com/album/music-from-saharan-whatsapp,,WHATSAPP-01,,,Anne Leach,chankelly@garrett.com,489-762-9313,,Anna Banks,3398 Klein Greens,,,,,,,,,Poland,PL,Mazovia,Warsaw,,
603,1/24/20 1:19pm,Bandcamp,album,Music from Saharan WhatsApp,Etran de L'Aïr,USD,4.0,1.0,,4.0,,,,0.29,paypal,4.0,0.0,754503469,,0.4,0.4,0.0,3.31,99.6,3.31,digital download,,http://etrandelair.bandcamp.com/album/music-from-saharan-whatsapp,,WHATSAPP-01,,,Jenna Owen,matthew44@gmail.com,3412453869,,Christopher Hodges,476 Alejandro Roads Suite 486,,,,,,,,,Denmark,DK,Capital Region,Copenhagen,Facebook,l.facebook.com
604,1/24/20 2:42pm,Bandcamp,album,Music from Saharan WhatsApp,Etran de L'Aïr,USD,1.0,1.0,,1.0,,,,0.11,credit card,1.0,0.0,3706520676,,0.1,0.1,0.0,0.79,100.39,0.79,digital download,,http://etrandelair.bandcamp.com/album/music-from-saharan-whatsapp,,WHATSAPP-01,,,Harold Henderson,oadams@gmail.com,419.074.2500x54481,,Richard Jones,196 Wyatt Lake,,,,,,,,,Poland,PL,Mazovia,Warsaw,Bandcamp Discover,bandcamp.com/#discover
605,1/24/20 4:08pm,Bandcamp,album,Music from Saharan WhatsApp,Etran de L'Aïr,USD,5.0,1.0,,5.0,,,,0.3,paypal,5.0,0.0,68873751,,0.5,0.5,0.0,4.2,104.59,4.2,digital download,,http://etrandelair.bandcamp.com/album/music-from-saharan-whatsapp,,WHATSAPP-01,,,Nicole Harris,thartman@leon.info,+1-876-964-4554x143,,Shannon Barton,1322 Jeffrey Parks,,,,,,,,,United States,US,RI,Barrington,Publish notice sent to your fans,
606,1/24/20 6:02pm,shop@sahelsounds.com,payout,,,USD,,,,,,,,0.17,transfer,16.92,16.75,t253611500,2W212024TF868245X,,,,-16.92,87.67,,,,,,,,,,,,,,,,,,,,,,,,,,,,
607,1/24/20 6:02pm,shop@sahelsounds.com,payout,,,USD,,,,,,,,0.24,transfer,24.16,23.92,t253611501,98867480G2269173U,,,,-24.16,63.51,,,,,,,,,,,,,,,,,,,,,,,,,,,,
608,1/24/20 6:16pm,Bandcamp,album,Sousoume Tamachek,Mdou Moctar,USD,7.0,1.0,,7.0,1.33,,,0.83,credit card,8.33,0.0,2766159210,,0.7,0.0,0.7,0.0,63.51,5.47,digital download,,http://mdoumoctar.bandcamp.com/album/sousoume-tamachek,,SS-043,191515 769435,,Patrick Webster,johnsonstacy@simpson-barrera.com,+1-167-569-2518x07183,,Zachary Dudley,841 Ross Pass Apt. 283,,,,,,,,,Germany,DE,Baden-Württemberg,Tamm,Bandcamp home page,bandcamp.com/
609,1/24/20 6:16pm,Bandcamp,album,Ilana: The Creator,Mdou Moctar,USD,7.0,1.0,,7.0,1.33,,,,,8.33,0.0,2766159210,,0.7,1.4,0.0,11.77,75.28,6.3,digital download,,http://mdoumoctar.bandcamp.com/album/ilana-the-creator,,SS-051,602318 136893,,David Coffey,paul76@guerrero.com,552-437-3880x89184,,Kiara Jackson,43128 Jasmine Drive,,,,,,,,,Germany,DE,Baden-Württemberg,Tamm,Bandcamp home page,bandcamp.com/
610,1/24/20 7:05pm,Bandcamp,album,Akounak Tedalat Taha Tazoughai OST,Mdou Moctar,USD,7.0,1.0,,7.0,1.33,,,0.78,paypal,8.33,0.0,975425341,,0.7,0.0,0.7,0.0,75.28,5.52,digital download,,http://mdoumoctar.bandcamp.com/album/akounak-tedalat-taha-tazoughai-ost,,SS-028,889326 667599,,Susan Orozco,samantha60@williams.biz,8910630148,,Madison Herrera,83386 Strickland Lane Suite 373,,,,,,,,,Germany,DE,Baden-Württemberg,Stuttgart,Bandcamp fan page: spacecowgirl,bandcamp.com/spacecowgirl
611,1/24/20 7:05pm,Bandcamp,album,Les Filles de Illighadad,Les Filles de Illighadad,USD,7.0,1.0,,7.0,1.33,,,,,8.33,0.0,975425341,,0.7,1.4,0.0,11.82,87.1,6.3,digital download,,http://lesfillesdeillighadad.bandcamp.com/album/les-filles-de-illighadad,,SS-033,889326 664918,,Justin Baker,silvaharold@dunn.com,5038336729,,Michael Mora,0171 Green Knolls Apt. 668,,,,,,,,,Germany,DE,Baden-Württemberg,Stuttgart,Bandcamp: spacecowgirl/following/artists_and_labels,bandcamp.com/spacecowgirl/following/artists_and_labels
612,1/24/20 7:28pm,Bandcamp,album,Music from Saharan WhatsApp,Etran de L'Aïr,USD,1.0,1.0,,1.0,,,,0.11,paypal,1.0,0.0,1740072906,,0.1,0.1,0.0,0.79,87.89,0.79,digital download,,http://etrandelair.bandcamp.com/album/music-from-saharan-whatsapp,,WHATSAPP-01,,,Kaitlyn Bryant,lkerr@yahoo.com,314.443.1522,,Jeremy Hancock,9302 Sheila Tunnel,,,,,,,,,France,FR,Paris,Paris,Bandcamp fan wishlist,bandcamp.com/tingyun
613,1/24/20 10:46pm,Bandcamp,album,Music from Saharan WhatsApp,Etran de L'Aïr,USD,2.0,1.0,,2.0,,,,0.15,paypal,2.0,0.0,3961445670,,0.2,0.2,0.0,1.65,89.54,1.65,digital download,,http://etrandelair.bandcamp.com/album/music-from-saharan-whatsapp,,WHATSAPP-01,,,Eric Jenkins,swhite@gmail.com,042-030-6062x86300,,Dawn Schroeder,3815 Foster Village,,,,,,,,,United States,US,WI,,,
614,1/24/20 11:01pm,Bandcamp,package,Sahel Sounds Label Sampler,Various Artists,USD,20.0,1.0,,20.0,,5.0,United States,0.85,credit card,25.0,0.0,3270486875,,2.0,2.0,0.0,22.15,111.69,17.15,Sahel Sounds t-shirt,Large,http://sahelsounds.bandcamp.com/merch/sahel-sounds-t-shirt,SS-T01-BLK-ULG,,,,Nicholas Barber,timothy78@smith-smith.net,+1-069-462-7579x30362,,Sandy Phillips,000 Cody Locks,9 Lomas dr.,durango,CO,81301,United States,US,,,United States,US,CO,durango,Google search,www.google.com/
615,1/24/20 11:33pm,Bandcamp,album,Music from Saharan WhatsApp,Etran de L'Aïr,USD,1.0,1.0,,1.0,,,,0.11,paypal,1.0,0.0,3908565390,,0.1,0.1,0.0,0.79,112.48,0.79,digital download,,http://etrandelair.bandcamp.com/album/music-from-saharan-whatsapp,,WHATSAPP-01,,,Anna Williams,williamswilliam@zimmerman.info,914.784.4589x67831,,Heather Jones,979 Kathy Prairie Apt. 763,,,,,,,,,United Kingdom,GB,,,Bandcamp search,bandcamp.com/app/android/search
616,1/24/20 11:57pm,Bandcamp,album,Ilana: The Creator,Mdou Moctar,USD,7.0,1.0,,7.0,1.4,,,0.54,paypal,8.4,0.0,346543730,,0.7,0.7,0.0,5.76,118.24,5.76,digital download,,http://mdoumoctar.bandcamp.com/album/ilana-the-creator,,SS-051,602318 136893,,Angela Lloyd,denise04@yahoo.com,(965)423-8322x13699,,Stephen Alvarado,3370 Guerrero Springs Apt. 246,,,,,,,,,United Kingdom,GB,East Sussex,Wych Cross,Google search,www.google.com/
617,1/25/20 2:48am,Bandcamp,album,Eghass Malan,Les Filles de Illighadad,USD,7.0,1.0,,7.0,,,,0.47,paypal,7.0,0.0,831082476,,0.7,0.7,0.0,5.83,124.07,5.83,digital download,,http://lesfillesdeillighadad.bandcamp.com/album/eghass-malan,,SS-044,191515 928351,,Mary Smith,jonathanpeck@gmail.com,001-937-016-8895x7374,,Cynthia Palmer,5975 Pamela Causeway Apt. 930,,,,,,,,,Australia,AU,VIC,Melbourne,Bandcamp search,bandcamp.com/app/ios/search
618,1/25/20 3:16am,Bandcamp,album,Ilana: The Creator,Mdou Moctar,USD,7.0,1.0,,7.0,,,,0.4,credit card,7.0,0.0,2934999229,,0.7,0.7,0.0,5.9,129.97,5.9,digital download,,http://mdoumoctar.bandcamp.com/album/ilana-the-creator,,SS-051,602318 136893,,Patricia Perkins,nburch@bass-miller.com,473-855-4190,,Brian Hernandez,37728 Nelson Branch Apt. 480,,,,,,,,,United States,US,AZ,Tempe,Bandcamp fan page: tristonwave4200,bandcamp.com/tristonwave4200
619,1/25/20 4:58am,Bandcamp,album,Music from Saharan WhatsApp,Etran de L'Aïr,USD,6.0,1.0,,6.0,,,,0.35,paypal,6.0,0.0,4106940075,,0.6,0.6,0.0,5.05,135.02,5.05,digital download,,http://etrandelair.bandcamp.com/album/music-from-saharan-whatsapp,,WHATSAPP-01,,,Ruben Hunter,thammond@rice.com,9384781254,,Herbert Robertson,31065 Andrews Prairie,,,,,,,,,United States,US,NY,Brooklyn,Bandcamp weekly newsletter,bandcamp.com
620,1/25/20 5:18am,Bandcamp,album,Les Filles de Illighadad,Les Filles de Illighadad,USD,7.0,1.0,,7.0,,,,0.61,credit card,7.0,0.0,3221281675,,0.7,0.0,0.7,0.0,135.02,5.69,digital download,,http://lesfillesdeillighadad.bandcamp.com/album/les-filles-de-illighadad,,SS-033,889326 664918,,Michael Davis,leetami@yahoo.com,+1-320-025-1420x41669,,Michael White,60196 Angela Court Suite 500,,,,,,,,,United States,US,VT,Essex Junction,Bandcamp fan wishlist,bandcamp.com/ericext
621,1/25/20 5:18am,Bandcamp,album,Eghass Malan,Les Filles de Illighadad,USD,7.0,1.0,,7.0,,,,,,7.0,0.0,3221281675,,0.7,1.4,0.0,11.99,147.01,6.3,digital download,,http://lesfillesdeillighadad.bandcamp.com/album/eghass-malan,,SS-044,191515 928351,,Ronnie Thomas,abigailpitts@rush-rojas.com,132-641-1330,,Desiree Oconnor,56970 Veronica Lakes Apt. 171,,,,,,,,,United States,US,VT,Essex Junction,Bandcamp fan wishlist,bandcamp.com/ericext
622,1/25/20 2:36pm,Bandcamp,album,Music from Saharan WhatsApp,Etran de L'Aïr,USD,2.0,1.0,,2.0,,,,0.15,paypal,2.0,0.0,3392121825,,0.2,0.2,0.0,1.65,148.66,1.65,digital download,,http://etrandelair.bandcamp.com/album/music-from-saharan-whatsapp,,WHATSAPP-01,,,Tasha Chandler,rjennings@snyder.com,719.544.7125x50076,,Ricky Robinson,3482 Stephanie Pine,,,,,,,,,United States,US,NJ,Pine Brook,Publish notice sent to your fans,
623,1/25/20 3:04pm,Bandcamp,package,La Musique Electronique du Niger,Mamman Sani,USD,12.0,1.0,,12.0,,4.0,United States,0.65,credit card,16.0,0.0,3020278694,,1.2,1.2,0.0,14.15,162.81,10.15,Mamman Sani CD,,http://mammansani.bandcamp.com/album/la-musique-electronique-du-niger,SS-011cd,SS-011,889326 664864,,Melanie Lane,amccormick@yahoo.com,048-737-0046x35987,,Erika Ramirez,19798 Stephen Meadows Apt. 555,,WASHINGTON,DC,20015,United States,US,1/28/20,,United States,US,DC,WASHINGTON,,
624,1/25/20 4:12pm,Bandcamp,album,Ilana: The Creator,Mdou Moctar,USD,7.0,1.0,,7.0,,,,0.4,gift card,7.0,0.0,3797099124,,0.7,0.7,0.0,5.9,168.71,5.9,digital download,,http://mdoumoctar.bandcamp.com/album/ilana-the-creator,,SS-051,602318 136893,,Chris Jenkins,batesdebbie@gmail.com,976-609-5187,,Nathan Ritter,7750 Moore Divide,,,,,,,,,United States,US,NC,Greensboro,Bandcamp search,bandcamp.com/autocomplete-search
625,1/25/20 4:23pm,Bandcamp,album,Torodi,Hama,USD,10.0,1.0,,10.0,,,,0.49,paypal,10.0,0.0,2262190750,,1.0,1.0,0.0,8.51,177.22,8.51,digital download,,http://hamasynth.bandcamp.com/album/torodi,,SS-025,889326 664833,,David Black,steven25@archer-palmer.com,276-331-7208,,Christine Blake,63633 Charles Point,,,,,,,,,United States,US,OR,Portland,,
626,1/25/20 5:44pm,Bandcamp,album,Ilana: The Creator,Mdou Moctar,USD,7.0,1.0,,7.0,,,,0.47,credit card,7.0,0.0,368659182,,0.7,0.7,0.0,5.83,183.05,5.83,digital download,,http://mdoumoctar.bandcamp.com/album/ilana-the-creator,,SS-051,602318 136893,,Marvin Baker,xnguyen@yahoo.com,822-421-7771x89032,,Rachel Sweeney,8200 Gabriela Summit,,,,,,,,,Canada,CA,ON,Vaughan,shop.sahelsounds.com,shop.sahelsounds.com/products/mdou-moctar-ilana-the-creator
627,1/25/20 6:02pm,shop@sahelsounds.com,payout,,,USD,,,,,,,,0.28,transfer,28.28,28.0,t253885730,8S420942U7372483A,,,,-28.28,154.77,,,,,,,,,,,,,,,,,,,,,,,,,,,,
628,1/25/20 6:03pm,shop@sahelsounds.com,payout,,,USD,,,,,,,,0.35,transfer,35.23,34.88,t253885729,7C1248490U5680242,,,,-35.23,119.54,,,,,,,,,,,,,,,,,,,,,,,,,,,,
629,1/25/20 6:41pm,Bandcamp,album,Anar,Mdou Moctar,USD,7.0,1.0,,7.0,,,,0.4,paypal,7.0,0.0,4170600677,,0.7,0.7,0.0,5.9,125.44,5.9,digital download,,http://mdoumoctar.bandcamp.com/album/anar,,SS-024,889326 664857,,Mary Anderson,vbrown@hess.com,2035526517,,Daniel Evans,48832 Michael Rue,,,,,,,,,United States,US,CA,Los Angeles,Google search,www.google.com/
630,1/25/20 7:25pm,Bandcamp,album,Music from Saharan WhatsApp,Etran de L'Aïr,USD,3.0,1.0,,3.0,,,,0.23,paypal,3.0,0.0,3213098377,,0.3,0.3,0.0,2.47,127.91,2.47,digital download,,http://etrandelair.bandcamp.com/album/music-from-saharan-whatsapp,,WHATSAPP-01,,,Joshua Schmidt,tamara99@hotmail.com,913-022-1488x2754,,John Thomas,02783 Kyle Estate,,,,,,,,,Germany,DE,Saxony,Dresden,Recommendations footer: new and notable,bandcamp.com/footer/nn/a1550838743
631,1/25/20 8:35pm,Bandcamp,album,Music from Saharan WhatsApp,Etran de L'Aïr,USD,1.0,1.0,,1.0,,,,0.11,credit card,1.0,0.0,1098159257,,0.1,0.1,0.0,0.79,128.7,0.79,digital download,,http://etrandelair.bandcamp.com/album/music-from-saharan-whatsapp,,WHATSAPP-01,,,Karen Williams,bcooper@novak.com,(305)736-2758x8939,,Johnny Henderson,66829 Melvin Station Apt. 848,,,,,,,,,Portugal,PT,Porto,Penafiel,Bandcamp fan wishlist,bandcamp.com/TERUMANIA
632,1/25/20 9:31pm,Bandcamp,album,Music from Saharan WhatsApp,Etran de L'Aïr,USD,5.0,1.0,,5.0,,,,0.3,paypal,5.0,0.0,517699822,,0.5,0.5,0.0,4.2,132.9,4.2,digital download,,http://etrandelair.bandcamp.com/album/music-from-saharan-whatsapp,,WHATSAPP-01,,,Darius Johnson,raytracy@yahoo.com,001-594-492-4480x9219,,Gloria Willis,505 Evan Causeway Apt. 982,,,,,,,,,United States,US,IL,Chicago,Bandcamp fan wishlist,bandcamp.com/kyleaeby
633,1/25/20 10:16pm,Bandcamp,album,Music from Saharan WhatsApp,Etran de L'Aïr,USD,10.0,1.0,,10.0,,,,0.49,paypal,10.0,0.0,1376465648,,1.0,1.0,0.0,8.51,141.41,8.51,digital download,,http://etrandelair.bandcamp.com/album/music-from-saharan-whatsapp,,WHATSAPP-01,,,Victoria Acosta,michael55@miller.com,001-426-272-1487x28486,,Andrea Perry,7536 Hawkins Extensions Suite 309,,,,,,,,,United States,US,GA,Atlanta,,
634,1/26/20 1:26am,Bandcamp,package,Ilana: The Creator,Mdou Moctar,USD,17.0,1.0,,17.0,,5.0,United States,0.78,credit card,22.0,0.0,3563464039,,1.7,1.7,0.0,19.52,160.93,14.52,Ilana LP,,http://mdoumoctar.bandcamp.com/album/ilana-the-creator,SS-051lp,SS-051,602318 136893,,Bonnie Baker,haleyterry@gmail.com,287.341.4484x34652,,Jesus Jones,8220 Annette Points Suite 381,,Ventura,CA,93006,United States,US,1/28/20,,United States,US,CA,Ventura,Google search,www.google.com/
635,1/26/20 3:24pm,Bandcamp,package,Zerzura (Original Soundtrack Recording),Ahmoudou Madassane,USD,15.0,1.0,,15.0,,10.0,United States,1.03,paypal,25.0,0.0,1221878178,,1.5,1.5,0.0,22.47,183.4,12.47,Zerzura DVD,,http://sahelsounds.bandcamp.com/merch/zerzura-dvd,SS-046DVD,,,,Robert Le,pgarcia@carpenter-flores.net,001-331-219-9198,,Caitlyn Arias,526 Jeremiah Valley Suite 343,Woodville,Swadlincote,,DE11 7HY,United Kingdom,GB,1/28/20,,United Kingdom,GB,,Swadlincote,Bandcamp artist: sahelsounds,sahelsounds.bandcamp.com/merch/zerzura-dvd
636,1/26/20 3:28pm,Bandcamp,album,Balani Show Super Hits: Electronic Street Parties from Mali,Various,USD,7.0,1.0,,7.0,1.47,,,0.57,credit card,8.47,0.0,3761027579,,0.7,0.7,0.0,5.73,189.13,5.73,digital download,,http://sahelsounds.bandcamp.com/album/balani-show-super-hits-electronic-street-parties-from-mali,,SS-021,889326 667643,,Megan Morris,christycole@yahoo.com,581.313.1720,,Sean Joseph,161 Erin Crossroad,,,,,,,,,Netherlands,NL,North Holland,Amsterdam,youtube.com,www.youtube.com/
637,1/26/20 3:46pm,Bandcamp,album,Taaritt,Mamman Sani,USD,7.0,1.0,,7.0,,,,0.4,credit card,7.0,0.0,1345621060,,0.7,0.7,0.0,5.9,195.03,5.9,digital download,,http://mammansani.bandcamp.com/album/taaritt,,SS-023,889326 664871,,Charles Morales,zcampbell@gmail.com,3068447263,,Gregory Roy,0527 Ricardo Center,,,,,,,,,United States,US,VA,Staunton,Google search,www.google.com/
638,1/26/20 4:52pm,Bandcamp,album,Music from Saharan WhatsApp,Etran de L'Aïr,USD,1.0,1.0,,1.0,,,,0.11,paypal,1.0,0.0,3382059088,,0.1,0.1,0.0,0.79,195.82,0.79,digital download,,http://etrandelair.bandcamp.com/album/music-from-saharan-whatsapp,,WHATSAPP-01,,,Cody White,ramostyler@hotmail.com,273-571-0630,,Regina Stout,2372 Megan Haven,,,,,,,,,Poland,PL,Mazovia,Warsaw,Bandcamp search,bandcamp.com/app/android/search
639,1/26/20 6:03pm,shop@sahelsounds.com,payout,,,USD,,,,,,,,0.92,transfer,92.05,91.13,t254122835,04J87006FK4788031,,,,-92.05,103.77,,,,,,,,,,,,,,,,,,,,,,,,,,,,
640,1/26/20 6:03pm,shop@sahelsounds.com,payout,,,USD,,,,,,,,0.27,transfer,27.49,27.22,t254122831,7FL7957784082031P,,,,-27.49,76.28,,,,,,,,,,,,,,,,,,,,,,,,,,,,
641,1/26/20 6:10pm,Bandcamp,album,Music from Saharan Cellphones,Various,USD,7.0,1.0,,7.0,1.4,,,0.57,credit card,8.4,0.0,2038579943,,0.7,0.7,0.0,5.73,82.01,5.73,digital download,,http://sahelsounds.bandcamp.com/album/music-from-saharan-cellphones,,SS-003,889326 667889,,Jeffery Garza,bartonlinda@hotmail.com,087.530.7936,,Elizabeth Collins,523 Jane Point Apt. 858,,,,,,,,,France,FR,Bas-Rhin,Strasbourg,Recommendations footer: artist recommendation,bandcamp.com/footer/ar/a639873524
642,1/26/20 8:27pm,Bandcamp,album,Music from Saharan WhatsApp,Etran de L'Aïr,USD,6.0,1.0,,6.0,,,,0.35,credit card,6.0,0.0,1519830464,,0.6,0.6,0.0,5.05,87.06,5.05,digital download,,http://etrandelair.bandcamp.com/album/music-from-saharan-whatsapp,,WHATSAPP-01,,,Daniel Jones,adam44@hotmail.com,001-000-511-7299,Thannks from NYC!,John Eaton,287 Melissa Ports,,,,,,,,,United States,US,NY,Brooklyn,Google search,www.google.com/
643,1/26/20 8:58pm,Bandcamp,album,Music from Saharan WhatsApp,Etran de L'Aïr,USD,6.0,1.0,,6.0,,,,0.41,credit card,6.0,0.0,3433882589,,0.6,0.6,0.0,4.99,92.05,4.99,digital download,,http://etrandelair.bandcamp.com/album/music-from-saharan-whatsapp,,WHATSAPP-01,,,Brandon Garrett,ffischer@gmail.com,930.129.4393,,Michelle Gonzalez,5521 Bond Overpass Suite 852,,,,,,,,,United Kingdom,GB,Edinburgh,Edinburgh,Google search,www.google.com/
644,1/26/20 9:01pm,Bandcamp,album,Music from Saharan WhatsApp,Etran de L'Aïr,USD,5.0,1.0,,5.0,,,,0.35,paypal,5.0,0.0,840350092,,0.5,0.5,0.0,4.15,96.2,4.15,digital download,,http://etrandelair.bandcamp.com/album/music-from-saharan-whatsapp,,WHATSAPP-01,,,Wayne Fitzgerald,jamesdavidson@franklin.com,642-556-4365x9028,,Richard Townsend,620 Travis Lights,,,,,,,,,United Kingdom,GB,Hertfordshire,Welwyn Garden City,Google search,www.google.com/
645,1/26/20 9:21pm,Bandcamp,package,Sahel Sounds Label Sampler,Various Artists,USD,20.0,1.0,,20.0,,5.0,United States,0.78,paypal,25.0,0.0,400490099,,2.0,2.0,0.0,22.22,118.42,17.22,Sahel Sounds t-shirt,Large,http://sahelsounds.bandcamp.com/merch/sahel-sounds-t-shirt,SS-T01-BLK-ULG,,,,David Salas,donald56@gmail.com,960-934-0682,,Melanie Knapp,936 Michael Neck,,durango,CO,81301,United States,US,1/28/20,,United States,US,CO,durango,,
646,1/27/20 12:05am,Bandcamp,package,Ilana: The Creator,Mdou Moctar,USD,8.0,1.0,,8.0,,4.0,United States,0.53,paypal,12.0,0.0,3069921939,,0.8,0.8,0.0,10.67,129.09,6.67,Ilana: The Creator cassette,,http://mdoumoctar.bandcamp.com/album/ilana-the-creator,SS-028cs,SS-051,602318 136893,,Cynthia Roman,edward27@cook.com,001-454-811-1467x188,"hey man! your music is transcendent, I appreciate what you do.  I am glad to be alive in the here and now to hear your sounds. I hope to one day experience a live performance.  Thank you for transmitting god's vibrations thru your fingers to my ears.  I hear you! Much respect, Jefe aka Johnny Chiba",Jennifer Garner,02351 Mitchell Ford,,Bronx,NY,10461,United States,US,1/28/20,,United States,US,NY,Bronx,Bandcamp search,bandcamp.com/autocomplete-search
647,1/27/20 12:58am,Bandcamp,album,Sahel Sounds Label Sampler,Various Artists,USD,3.0,1.0,,3.0,,,,0.2,paypal,3.0,0.0,1689673754,,0.3,0.3,0.0,2.5,131.59,2.5,digital download,,http://sahelsounds.bandcamp.com/album/sahel-sounds-label-sampler,,SS-058,602318 137111,,Kylie Freeman,danielrodriguez@hotmail.com,(235)469-3005,,Rachel Nguyen,677 Jackson Forest,,,,,,,,,United States,US,MA,Wellesley Hills,Recommendations footer: artist recommendation,bandcamp.com/footer/ar/a4289860543
648,1/27/20 1:00am,Bandcamp,album,Tenere,Afous d'Afous,USD,7.0,1.0,,7.0,,,,0.57,paypal,7.0,0.0,3246854361,,0.7,0.0,0.7,0.0,131.59,5.73,digital download,,http://afousdafous.bandcamp.com/album/tenere,,SS-042,191515 490421,,Danny Hansen,guy20@mills.com,001-373-526-9986x98919,,Benjamin Murphy,608 Jason Key,,,,,,,,,United States,US,MA,Wellesley Hills,,
649,1/27/20 1:00am,Bandcamp,album,Isswat,Fadimoutou Wallet Inamoud,USD,7.0,1.0,,7.0,,,,,,7.0,0.0,3246854361,,0.7,1.4,0.0,12.03,143.62,6.3,digital download,,http://fadimoutouwalletinamoud.bandcamp.com/album/isswat,,SS-026,889326 667872,,Walter Williams,wayne56@yahoo.com,+1-633-035-3325x7109,,Kristina Woods,88614 Robert Trail,,,,,,,,,United States,US,MA,Wellesley Hills,,
650,1/27/20 3:42am,Bandcamp,package,Taaritt,Mamman Sani,USD,17.0,1.0,,17.0,,22.0,United States,1.43,paypal,39.0,0.0,2755552582,,1.7,1.7,0.0,35.87,179.49,13.87,Taaritt LP,,http://mammansani.bandcamp.com/album/taaritt,SS-023lp,SS-023,889326 664871,,Megan Chavez,kmoore@flores.net,001-871-059-2726x4490,,Dustin Anderson,344 Daniels Roads Suite 410,,"2-33-18 Jingumae, Shibuya-ku",Tokyo,1500001,Japan,JP,1/28/20,,Japan,JP,Tokyo,"2-33-18 Jingumae, Shibuya-ku",YouTube: 9dGt1ArYCrI,www.youtube.com/watch?v=9dGt1ArYCrI
651,1/27/20 5:41am,Bandcamp,album,Music from Saharan WhatsApp,Etran de L'Aïr,USD,6.0,1.0,,6.0,,,,0.35,paypal,6.0,0.0,1644262913,,0.6,0.6,0.0,5.05,184.54,5.05,digital download,,http://etrandelair.bandcamp.com/album/music-from-saharan-whatsapp,,WHATSAPP-01,,,Jeremy Moran,frederickabigail@zamora.com,+1-543-355-4716,,Thomas Barr,6350 John Walk Apt. 620,,,,,,,,,United States,US,CO,Denver,Publish notice sent to your fans,
652,1/27/20 11:23am,Bandcamp,album,Music from Saharan WhatsApp,Etran de L'Aïr,USD,5.0,1.0,,5.0,,,,0.3,credit card,5.0,0.0,2010682727,,0.5,0.5,0.0,4.2,188.74,4.2,digital download,,http://etrandelair.bandcamp.com/album/music-from-saharan-whatsapp,,WHATSAPP-01,,,Michael Brown,lesliefitzgerald@meyer-davis.com,523-398-4032,,Michael Martin,95222 Robert Flat,,,,,,,,,United States,US,NY,The Bronx,,
653,1/27/20 2:14pm,Bandcamp,album,Ilana: The Creator,Mdou Moctar,USD,7.0,1.0,,7.0,1.4,,,0.54,paypal,8.4,0.0,3551665533,,0.7,0.7,0.0,5.76,194.5,5.76,digital download,,http://mdoumoctar.bandcamp.com/album/ilana-the-creator,,SS-051,602318 136893,,Kristi Miller,nancy50@hotmail.com,966.231.1259,,Robert Mccullough,079 Grant Alley Apt. 059,,,,,,,,,United Kingdom,GB,Royal Kensington and Chelsea,Chelsea,Google search,www.google.com/
654,1/27/20 6:02pm,shop@sahelsounds.com,payout,,,USD,,,,,,,,0.2,transfer,20.05,19.85,t254342097,3T962491K0341601G,,,,-20.05,174.45,,,,,,,,,,,,,,,,,,,,,,,,,,,,
655,1/27/20 6:02pm,shop@sahelsounds.com,payout,,,USD,,,,,,,,0.56,transfer,56.23,55.67,t254342101,2NM723385M162683E,,,,-56.23,118.22,,,,,,,,,,,,,,,,,,,,,,,,,,,,
656,1/27/20 7:11pm,Bandcamp,album,Music from Saharan WhatsApp,Etran de L'Aïr,USD,1.0,1.0,,1.0,,,,0.1,paypal,1.0,0.0,921654276,,0.1,0.1,0.0,0.8,119.02,0.8,digital download,,http://etrandelair.bandcamp.com/album/music-from-saharan-whatsapp,,WHATSAPP-01,,,Daniel Pierce,kimberlypearson@reynolds.info,512.070.0399,,Janice Brown,062 Scott Islands Apt. 222,,,,,,,,,United States,US,WI,Rhinelander,Recommendations footer: new and notable,bandcamp.com/footer/nn/a3681570634
657,1/27/20 7:12pm,Bandcamp,album,Music from Saharan WhatsApp,Etran de L'Aïr,USD,3.0,1.0,,3.0,,,,0.2,paypal,3.0,0.0,3950096318,,0.3,0.3,0.0,2.5,121.52,2.5,digital download,,http://etrandelair.bandcamp.com/album/music-from-saharan-whatsapp,,WHATSAPP-01,,,Michele Aguilar,xmoore@romero.info,(997)225-4647,,Pamela Watkins,3425 Marcus Plaza,,,,,,,,,United States,US,MA,Springfield,Bandcamp search,bandcamp.com/app/android/search
658,1/27/20 9:16pm,Bandcamp,album,Sahel Sounds Label Sampler,Various Artists,USD,5.0,1.0,,5.0,,,,0.3,paypal,5.0,0.0,3808050640,,0.5,0.5,0.0,4.2,125.72,4.2,digital download,,http://sahelsounds.bandcamp.com/album/sahel-sounds-label-sampler,,SS-058,602318 137111,,Sarah Ward,rbrennan@yahoo.com,+1-733-178-7590x5434,,Hannah Hill,2189 Morris Cliffs,,,,,,,,,United States,US,IL,Waukegan,Google search,www.google.com/
659,1/27/20 9:57pm,Bandcamp,album,Music from Saharan WhatsApp,Etran de L'Aïr,USD,1.0,1.0,,1.0,,,,0.11,credit card,1.0,0.0,2479743869,,0.1,0.1,0.0,0.79,126.51,0.79,digital download,,http://etrandelair.bandcamp.com/album/music-from-saharan-whatsapp,,WHATSAPP-01,,,Bruce Cox,moorescott@mitchell-avila.org,604-059-6347,,William Gomez,088 Christina Springs Suite 601,,,,,,,,,Spain,ES,Barcelona,Barcelona,Bandcamp search,bandcamp.com/autocomplete-search
660,1/27/20 10:09pm,Bandcamp,album,Music from Saharan WhatsApp,Etran de L'Aïr,USD,1.0,1.0,,1.0,,,,0.11,credit card,1.0,0.0,3429266979,,0.1,0.1,0.0,0.79,127.3,0.79,digital download,,http://etrandelair.bandcamp.com/album/music-from-saharan-whatsapp,,WHATSAPP-01,,,Kimberly Dickerson,johnsmith@gmail.com,(852)859-5481x5906,,Elizabeth Bowen,41936 Rodriguez Run,,,,,,,,,United Kingdom,GB,Bristol,Bristol,Bandcamp fan wishlist,bandcamp.com/moomism
661,1/27/20 11:14pm,Bandcamp,album,Music from Saharan WhatsApp,Etran de L'Aïr,USD,10.0,1.0,,10.0,,,,0.52,credit card,10.0,0.0,8718705,,1.0,1.0,0.0,8.48,135.78,8.48,digital download,,http://etrandelair.bandcamp.com/album/music-from-saharan-whatsapp,,WHATSAPP-01,,,Justin Harris,aorr@gmail.com,001-763-366-4719x556,,John Stone,43770 Allen Dale Suite 028,,,,,,,,,United States,US,NY,Rochester,Google search,www.google.com/
662,1/27/20 11:31pm,Bandcamp,album,Music from Saharan WhatsApp,Etran de L'Aïr,USD,1.0,1.0,,1.0,,,,0.1,credit card,1.0,0.0,1716909195,,0.1,0.1,0.0,0.8,136.58,0.8,digital download,,http://etrandelair.bandcamp.com/album/music-from-saharan-whatsapp,,WHATSAPP-01,,,Shaun Morrison,dwilliams@wiley.biz,514-878-7927,,Olivia Figueroa,56737 Mario Drive Apt. 631,,,,,,,,,United States,US,MI,Oscoda,Bandcamp music feed: garynorton092 - markvandijk,http://blog.bandcamp.com/2013/09/19/strap-on-your-feed-bag/
663,1/28/20 12:32am,Bandcamp,package,Alghafiat,Amanar De Kidal,USD,7.0,1.0,,7.0,,4.0,United States,0.51,paypal,11.0,0.0,2239948764,,0.7,0.7,0.0,9.79,146.37,5.79,Limited Edition CD,,http://amanardekidal.bandcamp.com/album/alghafiat,ADK-A-LEC,SS-009,889326 664826,,Kendra Hopkins,brittney42@welch.biz,+1-819-177-9146x278,,Kayla Manning,9216 Jeffrey Prairie Suite 305,,Mount Rainier,MD,20712,United States,US,1/28/20,,United States,US,MD,Mount Rainier,,
664,1/28/20 12:34am,Bandcamp,album,Isswat,Fadimoutou Wallet Inamoud,USD,7.0,1.0,,7.0,,,,0.4,paypal,7.0,0.0,4138212983,,0.7,0.7,0.0,5.9,152.27,5.9,digital download,,http://fadimoutouwalletinamoud.bandcamp.com/album/isswat,,SS-026,889326 667872,,Linda Brennan,tina14@sanders.com,952-550-0212x6481,,Patrick Baird,260 Denise Parkway,,,,,,,,,United States,US,MO,St Louis,sahelsounds.com,sahelsounds.com/artists/amanar/
665,1/28/20 12:43am,Bandcamp,album,Music from Saharan WhatsApp,Etran de L'Aïr,USD,5.0,1.0,,5.0,,,,0.3,paypal,5.0,0.0,2650323067,,0.5,0.5,0.0,4.2,156.47,4.2,digital download,,http://etrandelair.bandcamp.com/album/music-from-saharan-whatsapp,,WHATSAPP-01,,,Brett Colon,elizabeth42@stanley.com,+1-426-508-5703x7667,,Dylan Brooks,072 Nicholas Plain,,,,,,,,,United States,US,MD,Silver Spring,Bandcamp fan wishlist,bandcamp.com/johnfenn3
666,1/28/20 2:29am,Bandcamp,package,Agrim Agadez,Various,USD,15.0,1.0,,15.0,,5.0,United States,0.74,credit card,20.0,0.0,2610407048,,1.5,1.5,0.0,17.76,174.23,12.76,Agrim Agadez LP,,http://sahelsounds.bandcamp.com/album/agrim-agadez,SS-038lp,SS-038,889326 872382,,Andrea Madden,vasqueztristan@horton.com,289.225.1825x57795,,Dennis Reynolds,034 Jennifer Shore,,North Providence,RI,2911,United States,US,1/28/20,,United States,US,RI,North Providence,Recommendations footer: artist recommendation,bandcamp.com/footer/ar/a2776328381
667,1/28/20 2:54am,Bandcamp,album,Music from Saharan WhatsApp,Etran de L'Aïr,USD,1.0,1.0,,1.0,,,,0.1,paypal,1.0,0.0,1739415257,,0.1,0.1,0.0,0.8,175.03,0.8,digital download,,http://etrandelair.bandcamp.com/album/music-from-saharan-whatsapp,,WHATSAPP-01,,,Alexander Bennett,justinfletcher@lutz.com,(158)470-9009x679,,Anthony Buchanan,53783 James Plaza,,,,,,,,,United States,US,IL,Lake Zurich,Bandcamp search,bandcamp.com/autocomplete-search
668,1/28/20 6:16am,Bandcamp,album,Music from Saharan WhatsApp,Etran de L'Aïr,USD,4.0,1.0,,4.0,,,,0.25,paypal,4.0,0.0,4187564662,,0.4,0.4,0.0,3.35,178.38,3.35,digital download,,http://etrandelair.bandcamp.com/album/music-from-saharan-whatsapp,,WHATSAPP-01,,,Kenneth Wilkinson,natalierodriguez@gmail.com,001-200-351-8062x40034,,Jeffrey Davis,781 Laura Ramp Suite 014,,,,,,,,,United States,US,MO,St Louis,,
669,1/28/20 6:18am,Bandcamp,album,Music from Saharan Cellphones,Various,USD,10.0,1.0,,10.0,,,,0.49,paypal,10.0,0.0,3653620352,,1.0,1.0,0.0,8.51,186.89,8.51,digital download,,http://sahelsounds.bandcamp.com/album/music-from-saharan-cellphones,,SS-003,889326 667889,,Michael Wallace,kayleedawson@moore.com,6569183190,,Melissa Wagner,789 Smith Cape,,,,,,,,,United States,US,IN,Munster,tumblr.com,www.tumblr.com/
670,1/28/20 6:24am,Bandcamp,album,Eghass Malan,Les Filles de Illighadad,USD,7.0,1.0,,7.0,,,,0.4,paypal,7.0,0.0,2545067639,,0.7,0.7,0.0,5.9,192.79,5.9,digital download,,http://lesfillesdeillighadad.bandcamp.com/album/eghass-malan,,SS-044,191515 928351,,Gary Wade,sara49@hotmail.com,279-999-7853x794,,Tony Brown,230 Alfred Plains Suite 070,,,,,,,,,United States,US,CA,Berkeley,Bandcamp search,bandcamp.com/app/android/search
671,1/28/20 8:18am,Bandcamp,album,Music from Saharan WhatsApp,Etran de L'Aïr,USD,6.0,1.0,,6.0,,,,0.41,paypal,6.0,0.0,162355868,,0.6,0.6,0.0,4.99,197.78,4.99,digital download,,http://etrandelair.bandcamp.com/album/music-from-saharan-whatsapp,,WHATSAPP-01,,,Alice Rollins,donald39@adams.com,(793)418-0027,,Melissa Fitzgerald,6793 Gilbert Gateway,,,,,,,,,United Kingdom,GB,,,Google search,www.google.co.uk/
672,1/28/20 8:40am,Bandcamp,album,Music from Saharan WhatsApp,Etran de L'Aïr,USD,3.0,1.0,,3.0,,,,0.11,credit card,3.0,0.0,3045470889,,0.3,0.3,0.0,2.59,200.37,2.59,digital download,,http://etrandelair.bandcamp.com/album/music-from-saharan-whatsapp,,WHATSAPP-01,,,Isaac Foster,peggy04@ball-houston.com,001-363-365-3741x61173,,Christine Brown,47322 Francis Underpass Suite 349,,,,,,,,,United States,US,OR,Portland,Google search,www.google.com/
673,1/28/20 12:37pm,Bandcamp,album,Music from Saharan WhatsApp,Etran de L'Aïr,USD,4.0,1.0,,4.0,,,,0.29,paypal,4.0,0.0,3490259135,,0.4,0.4,0.0,3.31,203.68,3.31,digital download,,http://etrandelair.bandcamp.com/album/music-from-saharan-whatsapp,,WHATSAPP-01,,,David Lawrence,byrdjeffrey@yahoo.com,4369197756,,Kelsey Foster,102 Christine Point,,,,,,,,,France,FR,Puy-de-Dôme,Clermont-Ferrand,,
674,1/28/20 1:02pm,Bandcamp,album,Les Filles de Illighadad,Les Filles de Illighadad,USD,7.0,1.0,,7.0,1.33,,,0.54,paypal,8.33,0.0,4209708075,,0.7,0.7,0.0,5.76,209.44,5.76,digital download,,http://lesfillesdeillighadad.bandcamp.com/album/les-filles-de-illighadad,,SS-033,889326 664918,,Lisa Carr,amymcdonald@pineda.biz,770.439.7599,,Paul Campbell,59896 Crystal Turnpike Suite 904,,,,,,,,,Germany,DE,North Rhine-Westphalia,Cologne,Google search,www.google.com/
675,1/28/20 1:02pm,Bandcamp,album,Sahel Sounds Label Sampler,Various Artists,USD,1.0,1.0,,1.0,,,,0.11,paypal,1.0,0.0,559050058,,0.1,0.1,0.0,0.79,210.23,0.79,digital download,,http://sahelsounds.bandcamp.com/album/sahel-sounds-label-sampler,,SS-058,602318 137111,,Frances Lambert,hmartinez@nelson.com,001-450-934-5423x11848,,Hayley Murphy,5646 Lewis Lodge Apt. 131,,,,,,,,,Germany,DE,North Rhine-Westphalia,Cologne,bandcamp.com,bandcamp.com
676,1/28/20 3:18pm,Bandcamp,album,Music from Saharan WhatsApp,Etran de L'Aïr,USD,1.0,1.0,,1.0,,,,0.1,credit card,1.0,0.0,1100841913,,0.1,0.1,0.0,0.8,211.03,0.8,digital download,,http://etrandelair.bandcamp.com/album/music-from-saharan-whatsapp,,WHATSAPP-01,,,Brittany Holmes,eturner@aguilar.com,987-484-0619x202,,David Wyatt,764 Andrew Islands,,,,,,,,,United States,US,TX,Austin,sahelsounds.com,sahelsounds.com/
677,1/28/20 4:49pm,Bandcamp,album,Music from Saharan WhatsApp,Etran de L'Aïr,USD,10.0,1.0,,10.0,,,,0.52,credit card,10.0,0.0,4041216894,,1.0,1.0,0.0,8.48,219.51,8.48,digital download,,http://etrandelair.bandcamp.com/album/music-from-saharan-whatsapp,,WHATSAPP-01,,,Christine Brown,jason40@caldwell-thomas.biz,+1-079-605-9210x8589,,Crystal Chung,181 Weber Prairie,,,,,,,,,United States,US,NC,Charlotte,,
678,1/28/20 5:45pm,Bandcamp,album,Music from Saharan WhatsApp,Etran de L'Aïr,USD,3.0,1.0,,3.0,,,,0.2,credit card,3.0,0.0,2684937080,,0.3,0.3,0.0,2.5,222.01,2.5,digital download,,http://etrandelair.bandcamp.com/album/music-from-saharan-whatsapp,,WHATSAPP-01,,,Blake Jimenez,moraleshaley@gmail.com,691-095-7423,,Colleen Gilbert,070 Lisa Burgs Apt. 999,,,,,,,,,United States,US,CA,Santa Monica,Bandcamp search,bandcamp.com/autocomplete-search
679,1/28/20 6:02pm,shop@sahelsounds.com,payout,,,USD,,,,,,,,0.92,transfer,92.28,91.36,t254563929,9VT54532DC611463G,,,,-92.28,129.73,,,,,,,,,,,,,,,,,,,,,,,,,,,,
680,1/28/20 6:02pm,shop@sahelsounds.com,payout,,,USD,,,,,,,,0.26,transfer,25.94,25.68,t254563926,3TB36864L9086110H,,,,-25.94,103.79,,,,,,,,,,,,,,,,,,,,,,,,,,,,
681,1/28/20 6:28pm,Bandcamp,refund,Sahel Sounds Label Sampler,Various Artists,USD,20.0,-1.0,,-20.0,,-5.0,United States,-0.85,credit card,-25.0,,t254569515,,-2.0,-2.0,0.0,-22.15,81.64,,Sahel Sounds t-shirt,Large,http://sahelsounds.bandcamp.com/merch/sahel-sounds-t-shirt,SS-T01-BLK-ULG,,,,John Hess,guerraryan@yahoo.com,(352)255-4804,,Sierra Brown,7927 Hunter Glens Apt. 819,9 Lomas dr.,durango,CO,81301,United States,US,,,United States,US,CO,durango,Google search,www.google.com/
682,1/28/20 7:36pm,Bandcamp,album,Music from Saharan WhatsApp,Etran de L'Aïr,USD,3.0,1.0,,3.0,,,,0.23,paypal,3.0,0.0,361078855,,0.3,0.3,0.0,2.47,84.11,2.47,digital download,,http://etrandelair.bandcamp.com/album/music-from-saharan-whatsapp,,WHATSAPP-01,,,Marvin Glover,mariacunningham@buckley-meyer.info,001-956-405-4634x04597,,Robert Zamora,95079 Megan Inlet Apt. 209,,,,,,,,,Spain,ES,Barcelona,Barcelona,Bandcamp search,bandcamp.com/app/android/search
683,1/28/20 8:43pm,Bandcamp,album,Ilana: The Creator,Mdou Moctar,USD,7.0,1.0,,7.0,,,,0.57,paypal,7.0,0.0,407036852,,0.7,0.0,0.7,0.0,84.11,5.73,digital download,,http://mdoumoctar.bandcamp.com/album/ilana-the-creator,,SS-051,602318 136893,,Andrew Wright,birddavid@gmail.com,6632047930,,Erika Floyd,774 Riley Valley,,,,,,,,,United States,US,WA,,Recommendations footer: album of the day,bandcamp.com/footer/aotd/a3521313782
684,1/28/20 8:43pm,Bandcamp,album,Akounak Tedalat Taha Tazoughai OST,Mdou Moctar,USD,7.0,1.0,,7.0,,,,,,7.0,0.0,407036852,,0.7,1.4,0.0,12.03,96.14,6.3,digital download,,http://mdoumoctar.bandcamp.com/album/akounak-tedalat-taha-tazoughai-ost,,SS-028,889326 667599,,Michael Knight,xkeller@davis.org,763.762.6943,,Shelby Lane,183 Melissa Trail,,,,,,,,,United States,US,WA,,Recommendations footer: album of the day,bandcamp.com/footer/aotd/a3521313782
685,1/28/20 9:08pm,Bandcamp,package,Balani Show Super Hits: Electronic Street Parties from Mali,Various,USD,17.0,1.0,,17.0,,5.0,United States,0.78,credit card,22.0,0.0,1727189174,,1.7,1.7,0.0,19.52,115.66,14.52,Balani LP,,http://sahelsounds.bandcamp.com/album/balani-show-super-hits-electronic-street-parties-from-mali,SS-BSSH-BL,SS-021,889326 667643,,Stephanie Ryan,jenniferlewis@hotmail.com,800-986-5657x1083,,Emily Reid,757 Jessica Plains,,San diego,CA,92101,United States,US,2/11/20,,United States,US,CA,San diego,Publish notice sent to your fans,
686,1/28/20 9:09pm,Bandcamp,package,Balani Show Super Hits: Electronic Street Parties from Mali,Various,USD,18.0,1.0,,18.0,,5.0,United States,0.74,paypal,23.0,0.0,3788460963,,1.8,1.8,0.0,20.46,136.12,15.46,Balani LP,,http://sahelsounds.bandcamp.com/album/balani-show-super-hits-electronic-street-parties-from-mali,SS-BSSH-BL,SS-021,889326 667643,,Joshua Ortiz,dandrews@yahoo.com,+1-584-791-9343x90560,,Sheri Spencer,859 Mathis Gateway Suite 385,,Cayey,PR,737,United States,US,2/11/20,,United States,US,PR,Cayey,Publish notice sent to your fans,
687,1/28/20 9:16pm,Bandcamp,album,Balani Show Super Hits: Electronic Street Parties from Mali,Various,USD,7.0,1.0,,7.0,,,,0.4,paypal,7.0,0.0,521328114,,0.7,0.7,0.0,5.9,142.02,5.9,digital download,,http://sahelsounds.bandcamp.com/album/balani-show-super-hits-electronic-street-parties-from-mali,,SS-021,889326 667643,,Christy Carrillo,baxterjulie@carlson.info,8201531097,,Tracie Hubbard,8986 Erika Cliff,,,,,,,,,United States,US,NY,Rochester,Publish notice sent to your fans,
688,1/28/20 9:23pm,Bandcamp,album,Music from Saharan WhatsApp,Etran de L'Aïr,USD,3.0,1.0,,3.0,,,,0.2,paypal,3.0,0.0,1301810330,,0.3,0.3,0.0,2.5,144.52,2.5,digital download,,http://etrandelair.bandcamp.com/album/music-from-saharan-whatsapp,,WHATSAPP-01,,,Carrie White,bhicks@thomas.com,817-160-4213x3422,,Douglas Ramsey,90892 Dalton Fields Apt. 572,,,,,,,,,United States,US,MN,Minneapolis,Publish notice sent to your fans,
689,1/28/20 9:26pm,Bandcamp,album,Falaw,Luka Productions,USD,7.0,1.0,,7.0,1.47,,,0.55,paypal,8.47,0.0,3523773242,,0.7,0.7,0.0,5.75,150.27,5.75,digital download,,http://lukaproductions.bandcamp.com/album/falaw,,SS-052,602318 136855,,Kyle Davis,tfischer@beck.com,813-675-7545x3557,,Annette Johnston,997 George Turnpike,,,,,,,,,Netherlands,NL,North Holland,Amsterdam,Publish notice sent to your fans,
690,1/28/20 9:32pm,Bandcamp,album,Music from Saharan WhatsApp,Etran de L'Aïr,USD,1.0,1.0,,1.0,,,,0.1,paypal,1.0,0.0,4111870001,,0.1,0.1,0.0,0.8,151.07,0.8,digital download,,http://etrandelair.bandcamp.com/album/music-from-saharan-whatsapp,,WHATSAPP-01,,,Robert Chen,xramos@becker.info,596-988-0802x0151,,Natalie Day,2161 Gonzalez Shoals Apt. 378,,,,,,,,,United States,US,NJ,Bordentown,,
691,1/28/20 9:48pm,Bandcamp,package,Balani Show Super Hits: Electronic Street Parties from Mali,Various,USD,17.0,1.0,,17.0,,5.0,United States,0.78,credit card,22.0,0.0,3597330722,,1.7,1.7,0.0,19.52,170.59,14.52,Balani LP,,http://sahelsounds.bandcamp.com/album/balani-show-super-hits-electronic-street-parties-from-mali,SS-BSSH-BL,SS-021,889326 667643,,Lauren Padilla,denisealvarez@gmail.com,001-643-822-1996x14640,,Aaron Cantu,1784 Nicole Groves,,Altadena,CA,91001-1702,United States,US,2/11/20,,United States,US,CA,Altadena,Publish notice sent to your fans,
692,1/28/20 9:50pm,Bandcamp,album,Balani Show Super Hits: Electronic Street Parties from Mali,Various,USD,7.0,1.0,,7.0,,,,0.47,paypal,7.0,0.0,704779067,,0.7,0.7,0.0,5.83,176.42,5.83,digital download,,http://sahelsounds.bandcamp.com/album/balani-show-super-hits-electronic-street-parties-from-mali,,SS-021,889326 667643,,Amber Chambers,ecalderon@smith.com,264.331.7273x1859,,Todd Edwards,19217 Megan Skyway,,,,,,,,,Guernsey,GG,,St Peter Port,Publish notice sent to your fans,
693,1/28/20 9:59pm,Bandcamp,package,Balani Show Super Hits: Electronic Street Parties from Mali,Various,USD,17.0,1.0,,17.0,,20.0,United States,1.48,credit card,37.0,0.0,3941393369,,1.7,1.7,0.0,33.82,210.24,13.82,Balani LP,,http://sahelsounds.bandcamp.com/album/balani-show-super-hits-electronic-street-parties-from-mali,SS-BSSH-BL,SS-021,889326 667643,,Sheila Ward,cindy59@gmail.com,(467)470-9050x146,,Sandra Perez,865 Kenneth Summit Apt. 438,,VOUHÉ,,79310,France,FR,2/11/20,,France,FR,,VOUHÉ,Publish notice sent to your fans,
694,1/28/20 10:22pm,Bandcamp,album,Balani Show Super Hits: Electronic Street Parties from Mali,Various,USD,8.0,1.0,,8.0,,,,0.45,paypal,8.0,0.0,1624257908,,0.8,0.8,0.0,6.75,216.99,6.75,digital download,,http://sahelsounds.bandcamp.com/album/balani-show-super-hits-electronic-street-parties-from-mali,,SS-021,889326 667643,,Eric Frey,foxmarc@lowe.info,+1-476-465-5662x6255,,George Weiss,9365 Reid Roads,,,,,,,,,United States,US,,,,
695,1/28/20 10:34pm,Bandcamp,album,Music from Saharan WhatsApp,Etran de L'Aïr,USD,1.0,1.0,,1.0,,,,0.11,paypal,1.0,0.0,4230839025,,0.1,0.1,0.0,0.79,217.78,0.79,digital download,,http://etrandelair.bandcamp.com/album/music-from-saharan-whatsapp,,WHATSAPP-01,,,Kristen Duncan,geraldmorales@craig-blake.com,001-405-926-6343x129,,Natalie Smith,07631 Paul Track Apt. 846,,,,,,,,,Netherlands,NL,South Holland,Dordrecht,Bandcamp search,bandcamp.com/autocomplete-search
696,1/28/20 11:30pm,Bandcamp,album,Eghass Malan,Les Filles de Illighadad,USD,7.0,1.0,,7.0,,,,0.47,paypal,7.0,0.0,1488155600,,0.7,0.7,0.0,5.83,223.61,5.83,digital download,,http://lesfillesdeillighadad.bandcamp.com/album/eghass-malan,,SS-044,191515 928351,,Maria Humphrey,eserrano@sutton.com,(549)600-3137,,Michelle Cooper,2046 Jamie Heights,,,,,,,,,Canada,CA,BC,Vancouver,Bandcamp search: “les filles de illighadad”,bandcamp.com/search?q=Les%20Filles%20de%20Illighadad
697,1/29/20 12:24am,Bandcamp,album,Balani Show Super Hits: Electronic Street Parties from Mali,Various,USD,8.0,1.0,,8.0,,,,0.45,paypal,8.0,0.0,1792383925,,0.8,0.8,0.0,6.75,230.36,6.75,digital download,,http://sahelsounds.bandcamp.com/album/balani-show-super-hits-electronic-street-parties-from-mali,,SS-021,889326 667643,,Sean Cole,jeffrey83@hotmail.com,894-445-8995x9151,,Sheila Williams,4082 Ramsey Route Apt. 986,,,,,,,,,United States,US,NJ,West Orange,Publish notice sent to your fans,
698,1/29/20 1:01am,Bandcamp,album,Balani Show Super Hits: Electronic Street Parties from Mali,Various,USD,7.0,1.0,,7.0,1.33,,,0.55,paypal,8.33,0.0,586273452,,0.7,0.7,0.0,5.75,236.11,5.75,digital download,,http://sahelsounds.bandcamp.com/album/balani-show-super-hits-electronic-street-parties-from-mali,,SS-021,889326 667643,,Sarah George,laurabrown@frey.com,(475)240-3250x62773,,Alexis Acosta,048 Phelps Plaza,,,,,,,,,Germany,DE,Land Berlin,Berlin,,
699,1/29/20 1:11am,Bandcamp,album,Eghass Malan,Les Filles de Illighadad,USD,7.0,1.0,,7.0,,,,0.4,credit card,7.0,0.0,4084864689,,0.7,0.7,0.0,5.9,242.01,5.9,digital download,,http://lesfillesdeillighadad.bandcamp.com/album/eghass-malan,,SS-044,191515 928351,,Carl Bray,ccooper@bell.com,(206)298-4584x63378,,Kevin Medina,9884 George Point Apt. 291,,,,,,,,,United States,US,CA,Oakland,duckduckgo.com,duckduckgo.com/
700,1/29/20 1:43am,Bandcamp,album,La Musique Electronique du Niger,Mamman Sani,USD,7.0,1.0,,7.0,,,,0.4,paypal,7.0,0.0,1926833136,,0.7,0.7,0.0,5.9,247.91,5.9,digital download,,http://mammansani.bandcamp.com/album/la-musique-electronique-du-niger,,SS-011,889326 664864,,Jonathan Sutton,david73@gray.com,+1-961-098-9480x46964,,Dylan Powers,472 Ann Loaf Apt. 611,,,,,,,,,United States,US,WA,Bellevue,Recommendations footer: artist recommendation,bandcamp.com/footer/ar/a2776328381
701,1/29/20 2:13am,Bandcamp,album,Balani Show Super Hits: Electronic Street Parties from Mali,Various,USD,10.0,1.0,,10.0,,,,0.49,paypal,10.0,0.0,3826046276,,1.0,1.0,0.0,8.51,256.42,8.51,digital download,,http://sahelsounds.bandcamp.com/album/balani-show-super-hits-electronic-street-parties-from-mali,,SS-021,889326 667643,,Brian Young,stacey09@gmail.com,9748959575,,Randy Walker,48901 Hernandez Views,,,,,,,,,United States,US,CA,Oakland,Publish notice sent to your fans,
702,1/29/20 2:48am,Bandcamp,package,Balani Show Super Hits: Electronic Street Parties from Mali,Various,USD,17.0,1.0,,17.0,,5.0,United States,0.72,paypal,22.0,0.0,3111156597,,1.7,1.7,0.0,19.58,276.0,14.58,Balani LP,,http://sahelsounds.bandcamp.com/album/balani-show-super-hits-electronic-street-parties-from-mali,SS-BSSH-BL,SS-021,889326 667643,,Jeffrey Ross,colemandavid@coffey.com,901.239.8854x26574,,Caitlin Hernandez,0717 James Rapids,Apt. 103,Los Angeles,CA,90034,United States,US,2/11/20,,United States,US,CA,Los Angeles,Publish notice sent to your fans,
703,1/29/20 2:52am,Bandcamp,album,Ilana: The Creator,Mdou Moctar,USD,10.0,1.0,,10.0,,,,0.49,paypal,10.0,0.0,1552415817,,1.0,1.0,0.0,8.51,284.51,8.51,digital download,,http://mdoumoctar.bandcamp.com/album/ilana-the-creator,,SS-051,602318 136893,,Jerry Sanders,danarobinson@santos.com,+1-428-706-4899x982,,Patrick Perez,0607 Gregg Motorway,,,,,,,,,United States,US,NY,The Bronx,Bandcamp search: “mdou moctar”,bandcamp.com/search?q=Mdou%20Moctar
704,1/29/20 3:51am,Bandcamp,album,Music from Saharan WhatsApp,Etran de L'Aïr,USD,3.0,1.0,,3.0,,,,0.2,paypal,3.0,0.0,690968275,,0.3,0.3,0.0,2.5,287.01,2.5,digital download,,http://etrandelair.bandcamp.com/album/music-from-saharan-whatsapp,,WHATSAPP-01,,,Andrew Riley,dhall@mendoza.org,(226)279-3222,,Jessica Lloyd,714 Wayne River,,,,,,,,,United States,US,NY,New York,sahelsounds.com,sahelsounds.com/
705,1/29/20 3:51am,Bandcamp,album,Music from Saharan WhatsApp,Etran de L'Aïr,USD,3.0,1.0,,3.0,,,,0.2,credit card,3.0,0.0,2539005596,,0.3,0.3,0.0,2.5,289.51,2.5,digital download,,http://etrandelair.bandcamp.com/album/music-from-saharan-whatsapp,,WHATSAPP-01,,,Steven Vaughn,bailey53@gmail.com,808.458.3847x076,,Heather Camacho,379 Daniel Inlet Apt. 966,,,,,,,,,United States,US,TX,Austin,Bandcamp search: “music from saharan whatsapp”,bandcamp.com/search?q=music%20from%20saharan%20whatsapp
706,1/29/20 4:04am,Bandcamp,album,Anou Malane,Abdallah Ag Oumbadougou,USD,7.0,1.0,,7.0,,,,0.47,paypal,7.0,0.0,707802416,,0.7,0.7,0.0,5.83,295.34,5.83,digital download,,http://abdallahagoumbadougou.bandcamp.com/album/anou-malane,,SS-053,602318 136992,,Charlotte Robertson,craig07@hines.org,001-624-443-9816x1202,,Joan Ramos,7015 Hammond Keys Suite 890,,,,,,,,,Canada,CA,BC,Kamloops,Publish notice sent to your fans,
707,1/29/20 4:05am,Bandcamp,album,Music from Saharan WhatsApp,Etran de L'Aïr,USD,5.0,1.0,,5.0,,,,0.35,credit card,5.0,0.0,1908726736,,0.5,0.5,0.0,4.15,299.49,4.15,digital download,,http://etrandelair.bandcamp.com/album/music-from-saharan-whatsapp,,WHATSAPP-01,,,Patricia Goodman,spencerbethany@gmail.com,994-998-0414x21622,,Natasha Williams,695 White Brook Suite 648,,,,,,,,,Canada,CA,ON,Toronto,Bandcamp fan wishlist,bandcamp.com/rotundcivet
708,1/29/20 7:51am,Bandcamp,album,Eghass Malan,Les Filles de Illighadad,USD,7.0,1.0,,7.0,,,,0.4,paypal,7.0,0.0,3797915812,,0.7,0.7,0.0,5.9,305.39,5.9,digital download,,http://lesfillesdeillighadad.bandcamp.com/album/eghass-malan,,SS-044,191515 928351,,Jennifer Snyder,andreagonzales@hotmail.com,873.286.0810,,Lisa Trujillo,80879 Christopher Estate,,,,,,,,,United States,US,NY,New York,,
709,1/29/20 8:48am,Bandcamp,album,Music from Saharan WhatsApp,Etran de L'Aïr,USD,1.0,1.0,,1.0,,,,0.1,paypal,1.0,0.0,3696649674,,0.1,0.1,0.0,0.8,306.19,0.8,digital download,,http://etrandelair.bandcamp.com/album/music-from-saharan-whatsapp,,WHATSAPP-01,,,Philip Knight,nortondavid@hotmail.com,(438)756-1335,,Richard Bradley,45474 Meyer Track Apt. 676,,,,,,,,,India,IN,Bihar,Patna,Google search,www.google.com/
710,1/29/20 9:55am,Bandcamp,album,La Musique Electronique du Niger,Mamman Sani,USD,7.0,1.0,,7.0,1.4,,,0.57,credit card,8.4,0.0,203608199,,0.7,0.7,0.0,5.73,311.92,5.73,digital download,,http://mammansani.bandcamp.com/album/la-musique-electronique-du-niger,,SS-011,889326 664864,,Lisa Melton,baileychristopher@rios-green.com,(207)397-3863,,Nicole Smith,301 Gibbs Shore Apt. 095,,,,,,,,,France,FR,Paris,Paris,Publish notice sent to your fans,
711,1/29/20 10:19am,Bandcamp,package,Balani Show Super Hits: Electronic Street Parties from Mali,Various,USD,17.0,1.0,,17.0,,5.0,United States,0.72,paypal,22.0,0.0,3598783107,,1.7,1.7,0.0,19.58,331.5,14.58,Balani LP,,http://sahelsounds.bandcamp.com/album/balani-show-super-hits-electronic-street-parties-from-mali,SS-BSSH-BL,SS-021,889326 667643,,Henry Stone,karencooper@soto.org,+1-225-890-3779x7645,,Caitlin Martin,50440 James Camp Suite 910,3A,Ridgewood,NY,11385,United States,US,2/11/20,,United States,US,NY,Ridgewood,Publish notice sent to your fans,
712,1/29/20 12:05pm,Bandcamp,album,Music from Saharan WhatsApp,Etran de L'Aïr,USD,3.0,1.0,,3.0,,,,0.23,paypal,3.0,0.0,1196857167,,0.3,0.3,0.0,2.47,333.97,2.47,digital download,,http://etrandelair.bandcamp.com/album/music-from-saharan-whatsapp,,WHATSAPP-01,,,Christine Smith,christinerivera@gmail.com,670.711.1298x365,,Jesse Carney,96669 Keith Ranch,,,,,,,,,United Kingdom,GB,Glasgow City,Glasgow,Bandcamp fan page: drammel,bandcamp.com/drammel
713,1/29/20 12:35pm,Bandcamp,album,Music from Saharan WhatsApp,Etran de L'Aïr,USD,10.0,1.0,,10.0,,,,0.59,paypal,10.0,0.0,283252867,,1.0,1.0,0.0,8.41,342.38,8.41,digital download,,http://etrandelair.bandcamp.com/album/music-from-saharan-whatsapp,,WHATSAPP-01,,,Elizabeth Kerr,iwagner@hamilton.org,+1-535-305-1689,,Tracy Ayala,981 Taylor Field,,,,,,,,,Australia,AU,QLD,Brisbane,Bandcamp search,bandcamp.com/autocomplete-search
714,1/29/20 3:47pm,Bandcamp,album,Music from Saharan WhatsApp,Etran de L'Aïr,USD,5.0,1.0,,5.0,,,,0.3,paypal,5.0,0.0,1559272635,,0.5,0.5,0.0,4.2,346.58,4.2,digital download,,http://etrandelair.bandcamp.com/album/music-from-saharan-whatsapp,,WHATSAPP-01,,,Shawn Smith,keithhenderson@gmail.com,353.300.4024,,Cindy Welch,45372 Michael Divide,,,,,,,,,United States,US,MN,Winona,Bandcamp artist: etrandelair,etrandelair.bandcamp.com/album/music-from-saharan-whatsapp
715,1/29/20 3:53pm,Bandcamp,album,Ilana: The Creator,Mdou Moctar,USD,7.0,1.0,,7.0,,,,0.4,credit card,7.0,0.0,1239606638,,0.7,0.7,0.0,5.9,352.48,5.9,digital download,,http://mdoumoctar.bandcamp.com/album/ilana-the-creator,,SS-051,602318 136893,,Nancy Gutierrez,wilsonkaren@hotmail.com,436-773-0247,,Chad Thomas,2198 Scott Terrace,,,,,,,,,United States,US,CA,Pasadena,Bandcamp search,bandcamp.com/autocomplete-search
716,1/29/20 3:59pm,Bandcamp,album,Music from Saharan WhatsApp,Etran de L'Aïr,USD,1.0,1.0,,1.0,,,,0.11,paypal,1.0,0.0,889633576,,0.1,0.1,0.0,0.79,353.27,0.79,digital download,,http://etrandelair.bandcamp.com/album/music-from-saharan-whatsapp,,WHATSAPP-01,,,Kristen Smith,gjones@ware.com,+1-387-593-3536x28344,,Kenneth Nguyen,0205 Weaver Neck,,,,,,,,,United Kingdom,GB,Bradford,Bradford,Google search,www.google.com/
717,1/29/20 4:10pm,Bandcamp,album,Anou Malane,Abdallah Ag Oumbadougou,USD,10.0,1.0,,10.0,,,,0.49,paypal,10.0,0.0,3414165210,,1.0,1.0,0.0,8.51,361.78,8.51,digital download,,http://abdallahagoumbadougou.bandcamp.com/album/anou-malane,,SS-053,602318 136992,,Michael Duncan,hvega@hotmail.com,(165)088-5290x42390,,Jorge Holmes,0804 Cooper Burg Apt. 363,,,,,,,,,United States,US,TX,Houston,Bandcamp search,bandcamp.com/autocomplete-search
718,1/29/20 4:12pm,Bandcamp,package,Sahel Sounds Label Sampler,Various Artists,USD,30.0,1.0,,30.0,,5.0,United States,0.97,paypal,35.0,0.0,493887506,,3.0,3.0,0.0,31.03,392.81,26.03,Sahel Sounds t-shirt,Large,http://sahelsounds.bandcamp.com/merch/sahel-sounds-t-shirt,SS-T01-BLK-ULG,,,,Nichole Hernandez,danielkim@johnson.com,(134)893-0376x614,,Kristin Rogers,772 Bradford Village Suite 158,,SAN JOSE,CA,95125,United States,US,2/4/20,,United States,US,CA,SAN JOSE,Bandcamp search: “sahel sounds”,bandcamp.com/search?q=sahel%20sounds
719,1/29/20 4:47pm,Bandcamp,album,La Musique Electronique du Niger,Mamman Sani,USD,7.0,1.0,,7.0,,,,0.4,credit card,7.0,0.0,2393944585,,0.7,0.7,0.0,5.9,398.71,5.9,digital download,,http://mammansani.bandcamp.com/album/la-musique-electronique-du-niger,,SS-011,889326 664864,,Janet Arnold,hoffmananthony@hotmail.com,(790)347-2308x2204,,Anne Choi,834 Cooper Mission,,,,,,,,,United States,US,VA,Charlottesville,Google search,www.google.com/
720,1/29/20 4:59pm,Bandcamp,album,Music from Saharan WhatsApp,Etran de L'Aïr,USD,3.0,1.0,,3.0,,,,0.2,paypal,3.0,0.0,3752500453,,0.3,0.3,0.0,2.5,401.21,2.5,digital download,,http://etrandelair.bandcamp.com/album/music-from-saharan-whatsapp,,WHATSAPP-01,,,Christopher Lang,traviscordova@hotmail.com,901-917-0575x17460,,Kent Thompson,2696 Cortez Plaza Suite 688,,,,,,,,,United States,US,PA,Philadelphia,Bandcamp music feed,http://blog.bandcamp.com/2013/09/19/strap-on-your-feed-bag/
721,1/29/20 5:12pm,Bandcamp,album,Music from Saharan WhatsApp,Etran de L'Aïr,USD,1.0,1.0,,1.0,,,,0.11,paypal,1.0,0.0,3432931973,,0.1,0.1,0.0,0.79,402.0,0.79,digital download,,http://etrandelair.bandcamp.com/album/music-from-saharan-whatsapp,,WHATSAPP-01,,,Mark Meyer,kevin51@gmail.com,(079)948-6698,,Sabrina Dickson,80633 Logan Drive,,,,,,,,,United Kingdom,GB,Sheffield,Sheffield,Bandcamp music feed,http://blog.bandcamp.com/2013/09/19/strap-on-your-feed-bag/
722,1/29/20 6:02pm,shop@sahelsounds.com,payout,,,USD,,,,,,,,0.45,transfer,45.01,44.56,t254783478,28A72957UJ450262T,,,,-45.01,356.99,,,,,,,,,,,,,,,,,,,,,,,,,,,,
723,1/29/20 6:02pm,shop@sahelsounds.com,payout,,,USD,,,,,,,,0.37,transfer,36.63,36.26,t254783475,4EC038780A9382207,,,,-36.63,320.36,,,,,,,,,,,,,,,,,,,,,,,,,,,,
724,1/29/20 6:27pm,Bandcamp,album,Music from Saharan WhatsApp,Etran de L'Aïr,USD,5.0,1.0,,5.0,,,,0.3,credit card,5.0,0.0,93571798,,0.5,0.5,0.0,4.2,324.56,4.2,digital download,,http://etrandelair.bandcamp.com/album/music-from-saharan-whatsapp,,WHATSAPP-01,,,Douglas Peterson,lopezalec@hotmail.com,(093)419-5023x0053,,Robin Miller,62369 Joseph Canyon Apt. 569,,,,,,,,,United States,US,IL,Skokie,Google search,www.google.com/
725,1/29/20 8:09pm,Bandcamp,album,Anou Malane,Abdallah Ag Oumbadougou,USD,7.0,1.0,,7.0,,,,0.4,paypal,7.0,0.0,780872893,,0.7,0.7,0.0,5.9,330.46,5.9,digital download,,http://abdallahagoumbadougou.bandcamp.com/album/anou-malane,,SS-053,602318 136992,,Mary Jacobs,donaldrodriguez@bell.com,(578)021-9469,,Lauren Mccormick,036 Campbell Mall,,,,,,,,,United States,US,NC,Charlotte,Publish notice sent to your fans,
726,1/29/20 10:05pm,Bandcamp,album,Music from Saharan WhatsApp,Etran de L'Aïr,USD,3.0,1.0,,3.0,,,,0.23,credit card,3.0,0.0,1891326235,,0.3,0.3,0.0,2.47,332.93,2.47,digital download,,http://etrandelair.bandcamp.com/album/music-from-saharan-whatsapp,,WHATSAPP-01,,,Trevor Collins,michaelphillips@yahoo.com,001-947-080-5451,,Sarah Boyer,09207 Nicole Throughway Suite 539,,,,,,,,,United Kingdom,GB,City of Westminster,Paddington,Google search,www.google.com/
727,1/29/20 10:45pm,Bandcamp,album,Ilana: The Creator,Mdou Moctar,USD,7.0,1.0,,7.0,1.54,,,0.55,paypal,8.54,0.0,1018699286,,0.7,0.7,0.0,5.75,338.68,5.75,digital download,,http://mdoumoctar.bandcamp.com/album/ilana-the-creator,,SS-051,602318 136893,,Alexander Guerra,robinsonvanessa@yahoo.com,239.806.0745x43495,,Ashley Ferrell,941 Jeremy Junction Suite 341,,,,,,,,,Slovenia,SI,Obcina Ivancna Gorica,Ivančna Gorica,Bandcamp fan wishlist,bandcamp.com/app/android/wishlist
728,1/29/20 10:57pm,Bandcamp,album,Anar,Mdou Moctar,USD,7.0,1.0,,7.0,1.4,,,0.57,credit card,8.4,0.0,892301782,,0.7,0.7,0.0,5.73,344.41,5.73,digital download,,http://mdoumoctar.bandcamp.com/album/anar,,SS-024,889326 664857,,Laura Williams,carolchaney@reyes.com,(425)434-0756,,Valerie Barber,43847 Olson Springs Suite 212,,,,,,,,,France,FR,Loire-Atlantique,Vertou,sahelsounds.com (embedded player),sahelsounds.com/artists/mdou-moctar/
729,1/30/20 2:41am,Bandcamp,album,Ilana: The Creator,Mdou Moctar,USD,7.0,1.0,,7.0,,,,0.4,paypal,7.0,0.0,1369739283,,0.7,0.7,0.0,5.9,350.31,5.9,digital download,,http://mdoumoctar.bandcamp.com/album/ilana-the-creator,,SS-051,602318 136893,,Gregory Mckinney,javier86@warner.com,(104)167-1878,,Carla Santana,0387 Robert Station Apt. 372,,,,,,,,,United States,US,NY,Corning,Bandcamp home page,bandcamp.com/
730,1/30/20 3:28am,Bandcamp,album,Ilana: The Creator,Mdou Moctar,USD,7.0,1.0,,7.0,,,,0.4,credit card,7.0,0.0,2250070940,,0.7,0.7,0.0,5.9,356.21,5.9,digital download,,http://mdoumoctar.bandcamp.com/album/ilana-the-creator,,SS-051,602318 136893,,Melissa Graham,pmarshall@gmail.com,(249)678-8865x56431,,Stephanie Martin,4557 Aaron Circle,,,,,,,,,United States,US,NY,Brooklyn,Bandcamp search,bandcamp.com/app/ios/search
731,1/30/20 5:15am,Bandcamp,album,Music from Saharan WhatsApp,Etran de L'Aïr,USD,3.0,1.0,,3.0,,,,0.2,paypal,3.0,0.0,1967589057,,0.3,0.3,0.0,2.5,358.71,2.5,digital download,,http://etrandelair.bandcamp.com/album/music-from-saharan-whatsapp,,WHATSAPP-01,,,Teresa Mcintyre,davidlewis@yahoo.com,272.683.2687x5016,,Brandon Kelly,2433 Kelsey Underpass Apt. 751,,,,,,,,,United States,US,DC,Washington,,
732,1/30/20 5:17am,Bandcamp,package,No. 1,Etran de L'Aïr,USD,17.0,1.0,,17.0,,5.0,United States,0.72,paypal,22.0,0.0,3130670178,,1.7,1.7,0.0,19.58,378.29,14.58,Limited Edition LP,,http://etrandelair.bandcamp.com/album/no-1,SS-045lp,SS-045,602318 136824,,Ruth Torres,natasha77@hotmail.com,568-156-1060x0011,,Michelle Anderson,333 Robert Skyway,,Fort Myers,FL,33912-1704,United States,US,2/4/20,,United States,US,FL,Fort Myers,Bandcamp fan wishlist,bandcamp.com/jo_dem
733,1/30/20 5:19am,Bandcamp,album,Les Filles de Illighadad,Les Filles de Illighadad,USD,10.0,1.0,,10.0,,,,0.49,paypal,10.0,0.0,379944373,,1.0,1.0,0.0,8.51,386.8,8.51,digital download,,http://lesfillesdeillighadad.bandcamp.com/album/les-filles-de-illighadad,,SS-033,889326 664918,,Clarence Bailey,nicholas09@yahoo.com,001-473-767-7852,,Charles Powers,974 Simmons Harbor Apt. 920,,,,,,,,,United States,US,CA,Chico,,
734,1/30/20 10:33am,Bandcamp,album,Music from Saharan WhatsApp,Etran de L'Aïr,USD,5.0,1.0,,5.0,,,,0.35,paypal,5.0,0.0,2804766045,,0.5,0.5,0.0,4.15,390.95,4.15,digital download,,http://etrandelair.bandcamp.com/album/music-from-saharan-whatsapp,,WHATSAPP-01,,,Paul Kennedy,jfoster@gmail.com,435-960-8186x910,,Michael Ellis,0267 Jessica Islands,,,,,,,,,Ireland,IE,Leinster,Dublin,Bandcamp search: “sahel sounds”,bandcamp.com/search?q=sahel%20sounds
735,1/30/20 10:34am,Bandcamp,package,Ilana: The Creator,Mdou Moctar,USD,17.0,1.0,,17.0,,4.0,United States,3.05,credit card,21.0,0.0,2247635282,,1.7,0.0,1.7,0.0,390.95,12.25,Ilana LP,,http://mdoumoctar.bandcamp.com/album/ilana-the-creator,SS-051lp,SS-051,602318 136893,,James Cook,bhernandez@gmail.com,+1-398-698-9981x79977,,James Mccullough,04028 Eric Burg,,Barcelona,Barcelona,8007,Spain,ES,2/4/20,,Spain,ES,Barcelona,Barcelona,,
736,1/30/20 10:34am,Bandcamp,package,Fasokan,Luka Productions,USD,17.0,1.0,,17.0,,7.0,United States,,,24.0,0.0,2247635282,,1.7,0.0,3.4,0.0,390.95,15.3,Fasokan LP,,http://lukaproductions.bandcamp.com/album/fasokan,SS-040lp,SS-040,889326 900344,,Susan Mccarthy,cynthiaespinoza@yahoo.com,001-374-459-3490,,Michael Mays,79837 Mcneil Haven Suite 637,,Barcelona,Barcelona,8007,Spain,ES,2/4/20,,Spain,ES,Barcelona,Barcelona,,
737,1/30/20 10:34am,Bandcamp,package,Eghass Malan,Les Filles de Illighadad,USD,17.0,1.0,,17.0,,24.0,United States,,,41.0,0.0,2247635282,,1.7,5.1,0.0,77.85,468.8,15.3,'Eghass Malan' LP,,http://lesfillesdeillighadad.bandcamp.com/album/eghass-malan,SS-044lp-1,SS-044,191515 928351,,Courtney Carter,scortez@shelton.org,(068)545-5184x766,,Albert Church,3280 Julie Gardens,,Barcelona,Barcelona,8007,Spain,ES,2/4/20,,Spain,ES,Barcelona,Barcelona,,
738,1/30/20 2:07pm,Bandcamp,album,Music from Saharan WhatsApp,Etran de L'Aïr,USD,1.0,1.0,,1.0,,,,0.11,paypal,1.0,0.0,2616290170,,0.1,0.1,0.0,0.79,469.59,0.79,digital download,,http://etrandelair.bandcamp.com/album/music-from-saharan-whatsapp,,WHATSAPP-01,,,Jason Jackson,nicholebuckley@patel.com,+1-163-027-1104x0506,,Donald Frey,11122 Paul Courts Apt. 077,,,,,,,,,United Kingdom,GB,Plymouth,Plymouth,Bandcamp music feed,http://blog.bandcamp.com/2013/09/19/strap-on-your-feed-bag/
739,1/30/20 2:07pm,Bandcamp,package,Taaritt,Mamman Sani,USD,18.0,1.0,,18.0,,5.0,United States,0.74,paypal,23.0,0.0,3961196539,,1.8,1.8,0.0,20.46,490.05,15.46,Taaritt LP,,http://mammansani.bandcamp.com/album/taaritt,SS-023lp,SS-023,889326 664871,,Grant Park,susanwhite@gmail.com,565-585-8708,,Tonya Smith,71176 Jennifer Rapid,,Oakwood,OH,45419,United States,US,2/4/20,,United States,US,OH,Oakwood,,
740,1/30/20 2:17pm,Bandcamp,album,Sahel Sounds Label Sampler,Various Artists,USD,1.0,1.0,,1.0,,,,0.11,paypal,1.0,0.0,2594428803,,0.1,0.1,0.0,0.79,490.84,0.79,digital download,,http://sahelsounds.bandcamp.com/album/sahel-sounds-label-sampler,,SS-058,602318 137111,,Jennifer Wu,lisa47@hotmail.com,(521)168-6160x9693,,Steven Pierce,411 Tonya Glen,,,,,,,,,Germany,DE,Baden-Württemberg,Karlsruhe,bandcamp.com,bandcamp.com
741,1/30/20 2:45pm,Bandcamp,album,Zerzura (Original Soundtrack Recording),Ahmoudou Madassane,USD,7.0,1.0,,7.0,1.47,,,0.55,paypal,8.47,0.0,159202689,,0.7,0.7,0.0,5.75,496.59,5.75,digital download,,http://ahmoudoumadassane.bandcamp.com/album/zerzura-original-soundtrack-recording,,SS-046,656605 382067,,Tiffany Berg,williamkennedy@gmail.com,267-675-6284,,Steven Walls,43122 Sandra Turnpike Apt. 687,,,,,,,,,Belgium,BE,Brussels Capital,Brussels,Google search,www.google.com/
742,1/30/20 3:07pm,Bandcamp,album,Uchronia – Field Recordings From Alternate Realities,Sahel Sounds,USD,5.0,1.0,,5.0,,,,0.35,credit card,5.0,0.0,3781870504,,0.5,0.5,0.0,4.15,500.74,4.15,digital download,,http://sahelsounds.bandcamp.com/album/uchronia-field-recordings-from-alternate-realities,,SS-000,,,Henry Daniels,fischervicki@burgess.org,196-587-0503,,Eric Decker,77232 Brock Walk,,,,,,,,,France,FR,Paris,Paris,Bandcamp fan page: fibreglass,bandcamp.com/fibreglass
743,1/30/20 6:02pm,shop@sahelsounds.com,payout,,,USD,,,,,,,,2.21,transfer,220.96,218.75,t255018162,68Y836471S035380D,,,,-220.96,279.78,,,,,,,,,,,,,,,,,,,,,,,,,,,,
744,1/30/20 6:02pm,shop@sahelsounds.com,payout,,,USD,,,,,,,,0.99,transfer,99.4,98.41,t255018161,40G89306J40385549,,,,-99.4,180.38,,,,,,,,,,,,,,,,,,,,,,,,,,,,
745,1/30/20 6:05pm,Bandcamp,album,Kani,Pheno S.,USD,7.0,1.0,,7.0,,,,1.2,credit card,7.0,0.0,865361915,,0.7,0.0,0.7,0.0,180.38,5.1,digital download,,http://phenos.bandcamp.com/album/kani,,SS-019,889326 667650,,Jennifer Wilcox,davisleslie@copeland.com,690-909-9325x409,,Chris Perez,132 David Loop,,,,,,,,,Lebanon,LB,Beyrouth,Beirut,Publish notice sent to your fans,
746,1/30/20 6:05pm,Bandcamp,album,Top WZN,Jeich Ould Badu and Ahmedou Ahmed Lewla,USD,7.0,1.0,,7.0,,,,,,7.0,0.0,865361915,,0.7,0.0,1.4,0.0,180.38,6.3,digital download,,http://topwzn.bandcamp.com/album/top-wzn,,SS-039,889326 860648,,Christine Hudson,brittany49@schneider-hancock.com,498-907-1545,,Jeremy Green,824 Alicia Streets,,,,,,,,,Lebanon,LB,Beyrouth,Beirut,Publish notice sent to your fans,
747,1/30/20 6:05pm,Bandcamp,album,Houmeissa,Hama,USD,7.0,1.0,,7.0,,,,,,7.0,0.0,865361915,,0.7,0.0,2.1,0.0,180.38,6.3,digital download,,http://hamasynth.bandcamp.com/album/houmeissa,,SS-049,656605 382364,,Johnathan Brennan,andrewballard@hotmail.com,001-160-247-9553x310,,Daniel Horne,5838 Johnson Spurs Suite 781,,,,,,,,,Lebanon,LB,Beyrouth,Beirut,Publish notice sent to your fans,
748,1/30/20 6:05pm,Bandcamp,album,Balani Show Super Hits: Electronic Street Parties from Mali,Various,USD,7.0,1.0,,7.0,,,,,,7.0,0.0,865361915,,0.7,2.8,0.0,24.0,204.38,6.3,digital download,,http://sahelsounds.bandcamp.com/album/balani-show-super-hits-electronic-street-parties-from-mali,,SS-021,889326 667643,,Vanessa Carrillo,christine83@hotmail.com,+1-917-773-3206,,Joseph Williams,505 Stark Mill Suite 435,,,,,,,,,Lebanon,LB,Beyrouth,Beirut,Publish notice sent to your fans,
749,1/30/20 8:02pm,Bandcamp,album,Music from Saharan WhatsApp,Etran de L'Aïr,USD,6.0,1.0,,6.0,,,,0.35,paypal,6.0,0.0,365406215,,0.6,0.6,0.0,5.05,209.43,5.05,digital download,,http://etrandelair.bandcamp.com/album/music-from-saharan-whatsapp,,WHATSAPP-01,,,Dustin Anderson,alexandrajordan@gmail.com,102-923-9168x395,,Michael Livingston,24165 Foster Trail Apt. 804,,,,,,,,,United States,US,MA,Medford,Bandcamp search,bandcamp.com/autocomplete-search
750,1/30/20 8:28pm,Bandcamp,album,Music from Saharan WhatsApp,Etran de L'Aïr,USD,2.0,1.0,,2.0,,,,0.35,credit card,2.0,0.0,3430416138,,0.2,0.0,0.2,0.0,209.43,1.45,digital download,,http://etrandelair.bandcamp.com/album/music-from-saharan-whatsapp,,WHATSAPP-01,,,Marie Mccarthy,probbins@hotmail.com,023-943-6530,,Paul Chandler,038 Justin Keys Suite 155,,,,,,,,,Poland,PL,Lesser Poland,Krakow,Bandcamp fan activity email,bandcamp.com
751,1/30/20 8:28pm,Bandcamp,album,Sahel Sounds Label Sampler,Various Artists,USD,3.0,1.0,,3.0,,,,,,3.0,0.0,3430416138,,0.3,0.5,0.0,4.15,213.58,2.7,digital download,,http://sahelsounds.bandcamp.com/album/sahel-sounds-label-sampler,,SS-058,602318 137111,,Andrew Colon,xmarsh@gmail.com,685.926.2026x6367,,Brittany Swanson,58122 Dennis Gateway,,,,,,,,,Poland,PL,Lesser Poland,Krakow,Recommendations footer: artist recommendation,bandcamp.com/footer/ar/a466185704
752,1/30/20 8:51pm,Bandcamp,album,Music from Saharan WhatsApp,Etran de L'Aïr,USD,6.0,1.0,,6.0,,,,0.41,paypal,6.0,0.0,4180304330,,0.6,0.6,0.0,4.99,218.57,4.99,digital download,,http://etrandelair.bandcamp.com/album/music-from-saharan-whatsapp,,WHATSAPP-01,,,John Mason,fergusonlogan@allen.info,4168295869,,Thomas Glass,272 Julia Spur,,,,,,,,,United Kingdom,GB,Highland,Muir of Ord,Bandcamp search,bandcamp.com/app/android/search
753,1/30/20 9:07pm,Bandcamp,package,Sahel Sounds Label Sampler,Various Artists,USD,20.0,1.0,,20.0,,5.0,United States,0.85,credit card,25.0,0.0,1528468073,,2.0,2.0,0.0,22.15,240.72,17.15,Sahel Sounds t-shirt,Small,http://sahelsounds.bandcamp.com/merch/sahel-sounds-t-shirt,SS-T01-BLK-USM,,,,Donald Jones,gomezwilliam@barajas.com,(109)998-2473x81318,,Christopher Little,8625 Emily Extension Apt. 162,,Oakland,CA,94605,United States,US,2/4/20,,United States,US,CA,Oakland,Google search,www.google.com/
754,1/30/20 9:08pm,Bandcamp,album,Les Filles de Illighadad,Les Filles de Illighadad,USD,7.0,1.0,,7.0,1.47,,,0.55,paypal,8.47,0.0,2525398065,,0.7,0.7,0.0,5.75,246.47,5.75,digital download,,http://lesfillesdeillighadad.bandcamp.com/album/les-filles-de-illighadad,,SS-033,889326 664918,,Joseph Moreno,kristen99@hotmail.com,699.209.9510,,Allison Bennett,797 Adam Walks Apt. 618,,,,,,,,,Belgium,BE,Brussels Capital,Brussels,Bandcamp fan wishlist,bandcamp.com/nicobxl
755,1/30/20 9:12pm,Bandcamp,album,Tiris,El Wali,USD,7.0,1.0,,7.0,,,,0.4,credit card,7.0,0.0,620106106,,0.7,0.7,0.0,5.9,252.37,5.9,digital download,,http://elwali.bandcamp.com/album/tiris,,SS-055,602318 136923,,James Howard,michaelgreen@davis-khan.com,416.393.1460,,Marissa Michael,9636 Gray Mountain,,,,,,,,,United States,US,CA,Los Angeles,Bandcamp search,bandcamp.com/autocomplete-search
756,1/31/20 2:11am,Bandcamp,album,Music from Saharan WhatsApp,Etran de L'Aïr,USD,2.0,1.0,,2.0,,,,0.15,credit card,2.0,0.0,1396144263,,0.2,0.2,0.0,1.65,254.02,1.65,digital download,,http://etrandelair.bandcamp.com/album/music-from-saharan-whatsapp,,WHATSAPP-01,,,Elizabeth Richard,julie50@gmail.com,(296)056-9577x5209,,Diana Castillo,871 Brandi Oval Apt. 244,,,,,,,,,Argentina,AR,Buenos Aires F.D.,Buenos Aires,Bandcamp New & Notable,bandcamp.com/#new-notable
757,1/31/20 3:03am,Bandcamp,album,Music from Saharan WhatsApp,Etran de L'Aïr,USD,3.0,1.0,,3.0,,,,0.2,paypal,3.0,0.0,3720662783,,0.3,0.3,0.0,2.5,256.52,2.5,digital download,,http://etrandelair.bandcamp.com/album/music-from-saharan-whatsapp,,WHATSAPP-01,,,Robert Haley,hermanstacey@hotmail.com,(036)827-1642x4405,,Melissa Hansen,946 Tanya Mountain Apt. 440,,,,,,,,,United States,US,PA,Philadelphia,youtube.com,www.youtube.com/
758,1/31/20 3:18am,Bandcamp,album,Music from Saharan WhatsApp,Etran de L'Aïr,USD,5.0,1.0,,5.0,,,,0.35,paypal,5.0,0.0,3820060667,,0.5,0.5,0.0,4.15,260.67,4.15,digital download,,http://etrandelair.bandcamp.com/album/music-from-saharan-whatsapp,,WHATSAPP-01,,,Amy Palmer,mturner@hotmail.com,+1-038-909-5515,,Kevin Strickland,637 Kristin Neck,,,,,,,,,United States,US,AZ,Tucson,,
759,1/31/20 3:31am,Bandcamp,album,La Musique Electronique du Niger,Mamman Sani,USD,7.0,1.0,,7.0,,,,0.4,paypal,7.0,0.0,1488679027,,0.7,0.7,0.0,5.9,266.57,5.9,digital download,,http://mammansani.bandcamp.com/album/la-musique-electronique-du-niger,,SS-011,889326 664864,,Michael Alexander,ihess@ramirez.com,782-765-5569x202,,Margaret Shah,17931 Brenda Terrace,,,,,,,,,United States,US,WI,Stevens Point,Bandcamp music feed,http://blog.bandcamp.com/2014/01/30/bandcamp-app-now-with-music-feed/
760,1/31/20 3:42am,Bandcamp,package,Tiris,El Wali,USD,17.0,1.0,,17.0,,5.0,United States,1.08,paypal,22.0,0.0,2184213432,,1.7,0.0,1.7,0.0,266.57,14.22,Tiris LP,,http://elwali.bandcamp.com/album/tiris,SS-055lp,SS-055,602318 136923,,Gary Gill,onelson@yahoo.com,+1-485-692-4437x962,,Jennifer Strong,59329 Joyce Ferry Suite 934,3801 Electric Rd.,Roanoke,VA,24018,United States,US,2/4/20,,United States,US,VA,Roanoke,Bandcamp search,bandcamp.com/app/android/search
761,1/31/20 3:42am,Bandcamp,package,Anou Malane,Abdallah Ag Oumbadougou,USD,17.0,1.0,,17.0,,2.0,United States,,,19.0,0.0,2184213432,,1.7,3.4,0.0,36.52,303.09,15.3,Vinyl,,http://abdallahagoumbadougou.bandcamp.com/album/anou-malane,SS-053lp,SS-053,602318 136992,,Curtis Cummings,glenndustin@gmail.com,281-840-5480x2500,,Timothy Bennett,14203 Shannon Drive,3801 Electric Rd.,Roanoke,VA,24018,United States,US,2/4/20,,United States,US,VA,Roanoke,Bandcamp search,bandcamp.com/app/android/search
762,1/31/20 5:38am,Bandcamp,album,Balani Show Super Hits: Electronic Street Parties from Mali,Various,USD,7.0,1.0,,7.0,,,,0.4,paypal,7.0,0.0,1534065396,,0.7,0.7,0.0,5.9,308.99,5.9,digital download,,http://sahelsounds.bandcamp.com/album/balani-show-super-hits-electronic-street-parties-from-mali,,SS-021,889326 667643,,Jennifer White,rodriguezjames@raymond.com,(543)679-6246x927,,Alex Bray,382 Patricia Inlet,,,,,,,,,Japan,JP,Tokyo,Tokyo,,
763,1/31/20 6:15am,Bandcamp,album,Ilana: The Creator,Mdou Moctar,USD,7.0,1.0,,7.0,,,,0.47,paypal,7.0,0.0,2760704843,,0.7,0.7,0.0,5.83,314.82,5.83,digital download,,http://mdoumoctar.bandcamp.com/album/ilana-the-creator,,SS-051,602318 136893,,Pamela Hill,jonathanpayne@yahoo.com,547.097.6783,,Charles Edwards,9289 Brad Brook Suite 595,,,,,,,,,Australia,AU,VIC,Balwyn North,Google search,www.google.com.au/
764,1/31/20 9:50am,Bandcamp,package,Akounak Tedalat Taha Tazoughai OST,Mdou Moctar,USD,17.0,1.0,,17.0,,4.0,United States,5.74,credit card,21.0,0.0,1629679578,,1.7,0.0,1.7,0.0,314.82,9.56,Akounak OST LP,,http://mdoumoctar.bandcamp.com/album/akounak-tedalat-taha-tazoughai-ost,SS-028lp-1,SS-028,889326 667599,,Colin Vaughan,michaelsantos@gmail.com,001-270-574-5417x269,,Darlene Simpson,2830 Barry Summit,,Skopje,mkd,1020,Serbia,RS,2/4/20,,Serbia,RS,mkd,Skopje,,
765,1/31/20 9:50am,Bandcamp,package,Anou Malane,Abdallah Ag Oumbadougou,USD,17.0,1.0,,17.0,,4.0,United States,,,21.0,0.0,1629679578,,1.7,0.0,3.4,0.0,314.82,15.3,Vinyl,,http://abdallahagoumbadougou.bandcamp.com/album/anou-malane,SS-053lp,SS-053,602318 136992,,Greg Kim,tanya48@yahoo.com,935.923.2559,,Matthew Harris,35953 Peterson Falls Suite 200,,Skopje,mkd,1020,Serbia,RS,2/4/20,,Serbia,RS,mkd,Skopje,,
766,1/31/20 9:50am,Bandcamp,package,No. 1,Etran de L'Aïr,USD,17.0,1.0,,17.0,,4.0,United States,,,21.0,0.0,1629679578,,1.7,0.0,5.1,0.0,314.82,15.3,Limited Edition LP,,http://etrandelair.bandcamp.com/album/no-1,SS-045lp,SS-045,602318 136824,,Clayton Mendez,jeffery01@moore-martinez.com,(080)895-0793,,Gina Lynn,25139 Simpson Bypass Suite 987,,Skopje,mkd,1020,Serbia,RS,2/4/20,,Serbia,RS,mkd,Skopje,,
767,1/31/20 9:50am,Bandcamp,package,Music from Saharan Cellphones: Volume 2,Various,USD,17.0,1.0,,17.0,,24.0,United States,,,41.0,0.0,1629679578,,1.7,0.0,6.8,0.0,314.82,15.3,Vinyl Edition of Music from Saharan Cellphones Volume 2,,http://sahelsounds.bandcamp.com/album/music-from-saharan-cellphones-volume-2,SS-012lp,SS-012,889326 667742,,Elizabeth Little,rmason@white.com,353.223.5857x705,,Linda Johnson,84835 Williams Mills,,Skopje,mkd,1020,Serbia,RS,2/4/20,,Serbia,RS,mkd,Skopje,,
768,1/31/20 9:50am,Bandcamp,package,Eghass Malan,Les Filles de Illighadad,USD,17.0,1.0,,17.0,,4.0,United States,,,21.0,0.0,1629679578,,1.7,0.0,8.5,0.0,314.82,15.3,'Eghass Malan' LP,,http://lesfillesdeillighadad.bandcamp.com/album/eghass-malan,SS-044lp-1,SS-044,191515 928351,,Robert Soto,davidking@gmail.com,+1-335-442-6916x673,,Felicia Navarro,333 Boone Circles,,Skopje,mkd,1020,Serbia,RS,2/4/20,,Serbia,RS,mkd,Skopje,,
769,1/31/20 9:50am,Bandcamp,package,Les Filles de Illighadad,Les Filles de Illighadad,USD,17.0,1.0,,17.0,,4.0,United States,,,21.0,0.0,1629679578,,1.7,0.0,10.2,0.0,314.82,15.3,Les Filles de Illighadad LP,,http://lesfillesdeillighadad.bandcamp.com/album/les-filles-de-illighadad,SS-033-LP,SS-033,889326 664918,,Shane Francis,ochoaamber@salinas.com,001-217-469-0498,,Jackie Miller,112 Rocha Camp Suite 223,,Skopje,mkd,1020,Serbia,RS,2/4/20,,Serbia,RS,mkd,Skopje,,
770,1/31/20 9:50am,Bandcamp,package,Taaritt,Mamman Sani,USD,17.0,1.0,,17.0,,7.0,United States,,,24.0,0.0,1629679578,,1.7,11.9,0.0,152.36,467.18,15.3,Taaritt LP,,http://mammansani.bandcamp.com/album/taaritt,SS-023lp,SS-023,889326 664871,,Shannon Horton,christensenamy@hotmail.com,+1-455-872-0980x74869,,Carla Taylor,71080 Todd Walk,,Skopje,mkd,1020,Serbia,RS,2/4/20,,Serbia,RS,mkd,Skopje,,
771,1/31/20 11:11am,Bandcamp,album,Music from Saharan WhatsApp,Etran de L'Aïr,USD,1.0,1.0,,1.0,,,,0.11,paypal,1.0,0.0,27471294,,0.1,0.1,0.0,0.79,467.97,0.79,digital download,,http://etrandelair.bandcamp.com/album/music-from-saharan-whatsapp,,WHATSAPP-01,,,Kristi Martin,laneshelly@hotmail.com,(029)656-9675,,Joshua Burton,473 Shelly Cape,,,,,,,,,United Kingdom,GB,England,London,Bandcamp music feed,http://blog.bandcamp.com/2014/01/30/bandcamp-app-now-with-music-feed/
772,1/31/20 1:22pm,Bandcamp,album,Tiris,El Wali,USD,8.0,1.0,,8.0,,,,0.45,paypal,8.0,0.0,1321099662,,0.8,0.8,0.0,6.75,474.72,6.75,digital download,,http://elwali.bandcamp.com/album/tiris,,SS-055,602318 136923,,Gail Frazier,livingstondaniel@gmail.com,(723)437-5936,,Gerald Jones,7575 Donna Land,,,,,,,,,United States,US,NJ,Montclair,Bandcamp search,bandcamp.com/autocomplete-search
773,1/31/20 1:27pm,Bandcamp,album,Sousoume Tamachek,Mdou Moctar,USD,8.0,1.0,,8.0,,,,0.45,paypal,8.0,0.0,1472558114,,0.8,0.8,0.0,6.75,481.47,6.75,digital download,,http://mdoumoctar.bandcamp.com/album/sousoume-tamachek,,SS-043,191515 769435,,Shawn Higgins,wellsgeorge@gmail.com,(197)841-9140x2694,,Wendy Hall,6878 Jacqueline Land Suite 600,,,,,,,,,United States,US,NJ,Montclair,Bandcamp search,bandcamp.com/autocomplete-search
774,1/31/20 1:33pm,Bandcamp,album,Music from Saharan WhatsApp,Etran de L'Aïr,USD,3.0,1.0,,3.0,,,,0.23,paypal,3.0,0.0,56578963,,0.3,0.3,0.0,2.47,483.94,2.47,digital download,,http://etrandelair.bandcamp.com/album/music-from-saharan-whatsapp,,WHATSAPP-01,,,Larry Parker,karen63@yahoo.com,+1-145-552-0484,,Christopher Levine,6825 Fleming Mountains Apt. 232,,,,,,,,,United Kingdom,GB,,,,
775,1/31/20 3:12pm,Bandcamp,album,Music from Saharan WhatsApp,Etran de L'Aïr,USD,3.0,1.0,,3.0,,,,0.2,credit card,3.0,0.0,3847096334,,0.3,0.3,0.0,2.5,486.44,2.5,digital download,,http://etrandelair.bandcamp.com/album/music-from-saharan-whatsapp,,WHATSAPP-01,,,Dana Stewart,gonzalezdaniel@hotmail.com,5406751749,,Jeffrey Mcdonald,14929 Hernandez Flat,,,,,,,,,Netherlands,NL,North Holland,Amsterdam,lesateliersclaus.com (embedded player),www.lesateliersclaus.com/
776,1/31/20 4:53pm,Bandcamp,album,Fasokan,Luka Productions,USD,10.0,1.0,,10.0,1.4,,,0.63,paypal,11.4,0.0,1933022768,,1.0,1.0,0.0,8.37,494.81,8.37,digital download,,http://lukaproductions.bandcamp.com/album/fasokan,,SS-040,889326 900344,,Joshua Hernandez,williamspatricia@barr.com,719-059-4232x0143,,Katelyn Jones,5199 Derrick Wall,,,,,,,,,United Kingdom,GB,Southwark,Dulwich,,
777,1/31/20 5:04pm,Bandcamp,album,Music from Saharan WhatsApp,Etran de L'Aïr,USD,3.0,1.0,,3.0,,,,0.23,credit card,3.0,0.0,1702413905,,0.3,0.3,0.0,2.47,497.28,2.47,digital download,,http://etrandelair.bandcamp.com/album/music-from-saharan-whatsapp,,WHATSAPP-01,,,Christopher Taylor,dustinweaver@wright.com,(533)706-1955x29976,,Jeremiah Riley,02402 Roach Lock,,,,,,,,,United Kingdom,GB,Islington,Finsbury,Bandcamp search,bandcamp.com/autocomplete-search
778,1/31/20 5:14pm,Bandcamp,package,Sahel Sounds Label Sampler,Various Artists,USD,20.0,1.0,,20.0,,15.0,United States,1.32,paypal,35.0,0.0,1163640221,,2.0,2.0,0.0,31.68,528.96,16.68,Sahel Sounds t-shirt,Medium,http://sahelsounds.bandcamp.com/merch/sahel-sounds-t-shirt,SS-T01-BLK-UMD,,,,Christina Young,marcthomas@howell.com,001-701-845-1301,,Cole Warren,6427 Robles Valleys,,Kiiminki,Oulun lääni,90900,Finland,FI,2/4/20,,Finland,FI,Oulun lääni,Kiiminki,Google search,www.google.fi/
779,1/31/20 5:56pm,Bandcamp,album,Ilana: The Creator,Mdou Moctar,USD,7.0,1.0,,7.0,,,,0.4,paypal,7.0,0.0,633526598,,0.7,0.7,0.0,5.9,534.86,5.9,digital download,,http://mdoumoctar.bandcamp.com/album/ilana-the-creator,,SS-051,602318 136893,,Lisa Mueller,mhaynes@david.org,(267)941-7903x424,,Juan Martin,997 Melissa Shores Apt. 395,,,,,,,,,United States,US,NC,Raleigh,Bandcamp fan page: neilicus10,bandcamp.com/neilicus10/wishlist
780,1/31/20 6:03pm,shop@sahelsounds.com,payout,,,USD,,,,,,,,1.44,transfer,143.63,142.19,t255296962,16S15196P5223831C,,,,-143.63,391.23,,,,,,,,,,,,,,,,,,,,,,,,,,,,
781,1/31/20 6:03pm,shop@sahelsounds.com,payout,,,USD,,,,,,,,0.37,transfer,36.75,36.38,t255296963,8CS77122CD873264T,,,,-36.75,354.48,,,,,,,,,,,,,,,,,,,,,,,,,,,,
782,1/31/20 6:47pm,Bandcamp,package,Sahel Sounds Label Sampler,Various Artists,USD,20.0,1.0,,20.0,,15.0,United States,1.42,credit card,35.0,0.0,847461411,,2.0,2.0,0.0,31.58,386.06,16.58,Sahel Sounds t-shirt,XXL,http://sahelsounds.bandcamp.com/merch/sahel-sounds-t-shirt,SS-T01-BLK-UXXL,,,,Albert Thompson,royjoseph@perry.com,9215341858,,Kelly Rhodes,604 Collins Field Apt. 329,,Madrid,Madrid,28224,Spain,ES,2/4/20,,Spain,ES,Madrid,Madrid,l.instagram.com,l.instagram.com/?u=https%3A%2F%2Fsahelsounds.bandcamp.com%2Falbum%2Fbalani-show-super-hits-electronic-street-parties-from-mali&e=ATMZ4XNl1lVJcVUhpL58ov--VwiFWP9M0cuLaEEEnqnjloQEoIq-LnUMO-8pjM_lOh-WEn6iUk_r1x4
783,1/31/20 6:59pm,Bandcamp,package,Sahel Sounds Label Sampler,Various Artists,USD,20.0,1.0,,20.0,,5.0,United States,0.85,credit card,25.0,0.0,2131353211,,2.0,2.0,0.0,22.15,408.21,17.15,Record Tote Bag with Space Camel,,http://sahelsounds.bandcamp.com/merch/record-tote-bag-with-space-camel,SS-tote,,,,Veronica King,patrick89@yahoo.com,+1-776-067-1220x1007,,Todd Winters,13320 Clinton Stravenue Suite 375,,Azusa,CA,91702,United States,US,2/4/20,,United States,US,CA,Azusa,Google search,www.google.com/
784,1/31/20 7:35pm,Bandcamp,album,Music from Saharan WhatsApp,Etran de L'Aïr,USD,5.52,1.0,,5.52,,,,0.38,paypal,5.52,0.0,3538859488,,0.55,0.55,0.0,4.59,412.8,4.59,digital download,,http://etrandelair.bandcamp.com/album/music-from-saharan-whatsapp,,WHATSAPP-01,,,Edward Rich,baldwinalexandra@hotmail.com,814-335-9672x465,"Thank you for your beautiful music, love from Amsterdam (Netherlands)!!",Jimmy Jackson,8606 Boone Bypass,,,,,,,,,Netherlands,NL,North Holland,Amsterdam,,
785,1/31/20 7:44pm,Bandcamp,album,Tiris,El Wali,USD,7.0,1.0,,7.0,,,,0.4,credit card,7.0,0.0,268303281,,0.7,0.7,0.0,5.9,418.7,5.9,digital download,,http://elwali.bandcamp.com/album/tiris,,SS-055,602318 136923,,Ryan Lopez,ddavidson@yahoo.com,001-152-216-5136,,Justin Henderson,070 Robinson Lights Apt. 653,,,,,,,,,United States,US,CA,Oakland,Bandcamp app fan collection: barbapop,bandcamp.com/barbapop
786,1/31/20 8:29pm,Bandcamp,album,Music from Saharan WhatsApp,Etran de L'Aïr,USD,15.0,1.0,,15.0,,,,0.74,paypal,15.0,0.0,2208486249,,1.5,1.5,0.0,12.76,431.46,12.76,digital download,,http://etrandelair.bandcamp.com/album/music-from-saharan-whatsapp,,WHATSAPP-01,,,Paul Bennett,dorislindsey@gmail.com,001-044-072-7107x695,,Hannah Smith,72026 Earl Rapid,,,,,,,,,Austria,AT,Salzburg,Salzburg,Bandcamp weekly newsletter,bandcamp.com
787,1/31/20 9:09pm,Bandcamp,album,Music from Saharan WhatsApp,Etran de L'Aïr,USD,6.0,1.0,,6.0,,,,0.41,paypal,6.0,0.0,2056957326,,0.6,0.6,0.0,4.99,436.45,4.99,digital download,,http://etrandelair.bandcamp.com/album/music-from-saharan-whatsapp,,WHATSAPP-01,,,Jeffrey Anderson,michaelwagner@gmail.com,+1-597-583-1248x993,,David Adams,458 Stefanie Valley,,,,,,,,,Ireland,IE,Leinster,Dublin,,
788,1/31/20 9:57pm,Bandcamp,album,Music from Saharan WhatsApp,Etran de L'Aïr,USD,3.0,1.0,,3.0,,,,0.23,credit card,3.0,0.0,3237236233,,0.3,0.3,0.0,2.47,438.92,2.47,digital download,,http://etrandelair.bandcamp.com/album/music-from-saharan-whatsapp,,WHATSAPP-01,,,Jacob James,fpatterson@hotmail.com,(422)248-8361x81432,,Patrick Graham,6607 Rodney Ville,,,,,,,,,United Kingdom,GB,Croydon,Croydon,,
789,1/31/20 10:23pm,Bandcamp,album,Ilana: The Creator,Mdou Moctar,USD,7.0,1.0,,7.0,,,,0.47,credit card,7.0,0.0,1507275757,,0.7,0.7,0.0,5.83,444.75,5.83,digital download,,http://mdoumoctar.bandcamp.com/album/ilana-the-creator,,SS-051,602318 136893,,Matthew Jones,richardsonjoshua@hunter.com,001-427-757-6125x80714,,Patricia Thomas,04556 Austin Oval,,,,,,,,,Canada,CA,ON,Toronto,Bandcamp search: “mdou moctar”,bandcamp.com/search?q=Mdou%20Moctar
790,1/31/20 11:32pm,Bandcamp,album,Field Recordings from the Sahel,Sahel Sounds,USD,1.0,1.0,,1.0,,,,0.6,credit card,1.0,0.0,424511416,,0.1,0.0,0.1,0.0,444.75,0.3,digital download,,http://sahelsounds.bandcamp.com/album/field-recordings-from-the-sahel,,SS-057,602318 137104,,Christopher Blake,robinsonsherry@gmail.com,(120)153-9216x68498,,Patrick Walker,17955 Harris Common,,,,,,,,,Netherlands,NL,North Holland,Amsterdam,,
791,1/31/20 11:32pm,Bandcamp,album,Eghass Malan,Les Filles de Illighadad,USD,7.0,1.0,,7.0,1.47,,,,,8.47,0.0,424511416,,0.7,0.8,0.0,6.6,451.35,6.3,digital download,,http://lesfillesdeillighadad.bandcamp.com/album/eghass-malan,,SS-044,191515 928351,,Megan Swanson,lauratorres@hotmail.com,935.903.6412x0483,,Peter Blake,4776 Becker Lodge,,,,,,,,,Netherlands,NL,North Holland,Amsterdam,Recommendations footer: commonly collected,bandcamp.com/footer/cc/a2286673087
