,date,paid to,item type,item name,artist,currency,item price,quantity,discount code,sub total,tax,shipping,ship from country name,transaction fee,fee type,item total,amount you received,bandcamp transaction id,paypal transaction id,assessed revenue share,collected revenue share,balance of revenue share,change to payout balance,payout balance,net amount,package,option,item url,sku,catalog number,upc,isrc,buyer name,buyer email,buyer phone,buyer note,ship to name,ship to street,ship to street 2,ship to city,ship to state,ship to zip,ship to country,ship to country code,ship date,ship notes,country,country code,region/state,city,referrer,referrer url
0,1/1/20 4:49am,Bandcamp,album,Sahel Sounds Label Sampler,Various Artists,USD,1.0,1.0,,1.0,,,,0.1,credit card,1.0,0.0,4078079163,,0.1,0.1,0.0,0.8,197.04,0.8,digital download,,http://sahelsounds.bandcamp.com/album/sahel-sounds-label-sampler,,SS-058,602318 137111,,Brian Williams,contrerasjessica@pugh.com,+1-141-880-7332,,Lindsay Malone,8799 Alexander Mall,,,,,,,,,United States,US,NY,Centereach,Recommendations footer: artist recommendation,bandcamp.com/footer/ar/a2285772157
1,1/1/20 1:35pm,Bandcamp,package,Eghass Malan,Les Filles de Illighadad,USD,12.0,1.0,,12.0,,4.0,United States,0.65,credit card,16.0,0.0,96221811,,1.2,1.2,0.0,14.15,211.19,10.15,'Eghass Malan' compact disc,,http://lesfillesdeillighadad.bandcamp.com/album/eghass-malan,SS-044cd-1,SS-044,191515 928351,,Jennifer Rodriguez,steelesteven@hotmail.com,022.243.7890x991,,Alyssa Pacheco,787 Andersen Shore Suite 995,,Hatfield,PA,19440,United States,US,1/7/20,,United States,US,PA,Hatfield,,
2,1/1/20 1:39pm,Bandcamp,album,Sahel Sounds Label Sampler,Various Artists,USD,1.0,1.0,,1.0,,,,0.1,credit card,1.0,0.0,425110236,,0.1,0.1,0.0,0.8,211.99,0.8,digital download,,http://sahelsounds.bandcamp.com/album/sahel-sounds-label-sampler,,SS-058,602318 137111,,Jennifer Rodriguez,marybenson@gmail.com,(332)018-4809x2332,,Jim Ortiz,1755 Snow Islands Suite 073,,,,,,,,,United States,US,PA,Perkasie,bandcamp.com,bandcamp.com
3,1/1/20 6:02pm,shop@sahelsounds.com,payout,,,USD,,,,,,,,1.21,transfer,120.62,119.41,t248046776,96E86811UH1789730,,,,-120.62,91.37,,,,,,,,,,,,,,,,,,,,,,,,,,,,
4,1/1/20 6:03pm,shop@sahelsounds.com,payout,,,USD,,,,,,,,0.24,transfer,23.6,23.36,t248046773,519496941R168554N,,,,-23.6,67.77,,,,,,,,,,,,,,,,,,,,,,,,,,,,
5,1/1/20 11:49pm,Bandcamp,package,Anou Malane,Abdallah Ag Oumbadougou,USD,8.0,1.0,,8.0,,14.0,United States,0.94,paypal,22.0,0.0,834045325,,0.8,0.8,0.0,20.26,88.03,6.26,Limited Edition Cassette,,http://abdallahagoumbadougou.bandcamp.com/album/anou-malane,SS-053cass,SS-053,602318 136992,,John Bowen,mauricemcclain@pearson.info,(854)210-9063x864,,Chelsea Evans,05223 Joshua Course Apt. 650,,Abbotsford,VIC,3067,Australia,AU,1/7/20,,Australia,AU,VIC,Abbotsford,,
6,1/2/20 8:50am,Bandcamp,album,Unreleased Tapes 1981-1984,Mamman Sani,USD,7.0,1.0,,7.0,1.61,,,0.55,paypal,8.61,0.0,1069399304,,0.7,0.7,0.0,5.75,93.78,5.75,digital download,,http://mammansani.bandcamp.com/album/unreleased-tapes-1981-1984,,SS-030,889326 667568,,Ivan Diaz,qhughes@yahoo.com,290-384-8206x203,,Jacob Kramer,224 Johnson Estate,,,,,,,,,Ireland,IE,Leinster,Dublin,,
7,1/2/20 2:11pm,Bandcamp,album,Music from Saharan Cellphones,Various,USD,7.0,1.0,,7.0,1.33,,,0.54,paypal,8.33,0.0,185534597,,0.7,0.7,0.0,5.76,99.54,5.76,digital download,,http://sahelsounds.bandcamp.com/album/music-from-saharan-cellphones,,SS-003,889326 667889,,Katherine Lopez,samantha53@yahoo.com,315.088.6465x838,,David Woodard,81167 Sheila Fall,,,,,,,,,Spain,ES,Las Palmas,Puerto del Rosario,Google search,www.google.com/
8,1/2/20 2:22pm,Bandcamp,album,Ilana: The Creator,Mdou Moctar,USD,10.0,1.0,,10.0,,,,0.62,credit card,10.0,0.0,1783748474,,1.0,1.0,0.0,8.38,107.92,8.38,digital download,,http://mdoumoctar.bandcamp.com/album/ilana-the-creator,,SS-051,602318 136893,,Alexander Bolton,conleydillon@hotmail.com,321-706-0724,,Steven Knight,80799 David Fords,,,,,,,,,Norway,NO,Innlandet,Hamar,,
9,1/2/20 2:57pm,Bandcamp,album,Ilana: The Creator,Mdou Moctar,USD,10.0,1.0,,10.0,,,,0.52,credit card,10.0,0.0,1355829645,,1.0,1.0,0.0,8.48,116.4,8.48,digital download,,http://mdoumoctar.bandcamp.com/album/ilana-the-creator,,SS-051,602318 136893,,Jessica Reed,nathanielrobinson@bates-rivera.info,1191020836,,Eddie David,845 Jacob Ramp,,,,,,,,,United States,US,WI,Madison,,
10,1/2/20 4:47pm,Bandcamp,package,Ilana: The Creator,Mdou Moctar,USD,17.0,1.0,,17.0,,5.0,United States,0.78,credit card,22.0,0.0,1215634628,,1.7,1.7,0.0,19.52,135.92,14.52,Ilana LP,,http://mdoumoctar.bandcamp.com/album/ilana-the-creator,SS-051lp,SS-051,602318 136893,,Robin Green,christopher22@marshall.org,9475522387,,Molly Osborn,1649 Clark Plains,,Edgewater,CO,80214,United States,US,1/7/20,,United States,US,CO,Edgewater,Google search,www.google.com/
11,1/2/20 6:02pm,shop@sahelsounds.com,payout,,,USD,,,,,,,,0.6,transfer,60.27,59.67,t248268544,3JH890996G8964929,,,,-60.27,75.65,,,,,,,,,,,,,,,,,,,,,,,,,,,,
12,1/2/20 6:02pm,shop@sahelsounds.com,payout,,,USD,,,,,,,,0.08,transfer,7.5,7.42,t248268545,2PC96109MF496504P,,,,-7.5,68.15,,,,,,,,,,,,,,,,,,,,,,,,,,,,
13,1/2/20 7:05pm,Bandcamp,album,Houmeissa,Hama,USD,20.0,1.0,,20.0,,,,0.74,credit card,20.0,0.0,2298748824,,2.0,2.0,0.0,17.26,85.41,17.26,digital download,,http://hamasynth.bandcamp.com/album/houmeissa,,SS-049,656605 382364,,Kimberly Ortega,hendrixlaurie@yahoo.com,(905)611-8346,,Sherry Smith,8453 Davis Wells,,,,,,,,,United States,US,WA,Seattle,Bandcamp search,bandcamp.com/app/ios/search
14,1/2/20 9:27pm,Bandcamp,package,Music from Saharan Cellphones: Volume 2,Various,USD,17.0,1.0,,17.0,,5.0,United States,0.72,paypal,22.0,0.0,2546278371,,1.7,1.7,0.0,19.58,104.99,14.58,Vinyl Edition of Music from Saharan Cellphones Volume 2,,http://sahelsounds.bandcamp.com/album/music-from-saharan-cellphones-volume-2,SS-012lp,SS-012,889326 667742,,John James,edward51@white.com,(557)937-1224x7262,,Jeffrey French,60397 Andrew Heights,,garner,NC,27529,United States,US,1/7/20,,United States,US,NC,garner,,
15,1/3/20 6:03pm,shop@sahelsounds.com,payout,,,USD,,,,,,,,0.68,transfer,68.15,67.47,t248506310,2F656360U34360258,,,,-68.15,36.84,,,,,,,,,,,,,,,,,,,,,,,,,,,,
16,1/3/20 7:56pm,Bandcamp,album,Music from Saharan Cellphones,Various,USD,7.0,1.0,,7.0,,,,0.4,paypal,7.0,0.0,2217721062,,0.7,0.7,0.0,5.9,42.74,5.9,digital download,,http://sahelsounds.bandcamp.com/album/music-from-saharan-cellphones,,SS-003,889326 667889,,David Thompson,iweber@gmail.com,969.224.1343x96207,,Kristina Diaz,27648 Richard Keys,,,,,,,,,United States,US,OR,Portland,,
17,1/3/20 10:06pm,Bandcamp,album,Les Filles de Illighadad,Les Filles de Illighadad,USD,7.0,1.0,,7.0,,,,0.4,paypal,7.0,0.0,3240632352,,0.7,0.7,0.0,5.9,48.64,5.9,digital download,,http://lesfillesdeillighadad.bandcamp.com/album/les-filles-de-illighadad,,SS-033,889326 664918,,Kristen Miller,parsonselizabeth@yahoo.com,1484323443,,Jennifer Howard,047 David Forest Suite 446,,,,,,,,,United States,US,NY,Nanuet,Bandcamp search: “les filles”,bandcamp.com/search?q=les%20filles
18,1/4/20 1:14am,Bandcamp,album,Music from Saharan Cellphones,Various,USD,7.0,1.0,,7.0,,,,0.4,credit card,7.0,0.0,893874145,,0.7,0.7,0.0,5.9,54.54,5.9,digital download,,http://sahelsounds.bandcamp.com/album/music-from-saharan-cellphones,,SS-003,889326 667889,,Gavin Smith,vasquezcorey@fox.com,9119671434,,Katherine Rios,52634 Jessica Manors Apt. 348,,,,,,,,,United States,US,IL,Belleville,,
19,1/4/20 2:33am,Bandcamp,album,Sahel Sounds Label Sampler,Various Artists,USD,1.0,1.0,,1.0,,,,0.1,credit card,1.0,0.0,4276172906,,0.1,0.1,0.0,0.8,55.34,0.8,digital download,,http://sahelsounds.bandcamp.com/album/sahel-sounds-label-sampler,,SS-058,602318 137111,,Samuel Dalton,henry74@reyes-ramirez.com,514.194.6944x0795,,David Rosario,3486 Davis Road,,,,,,,,,United States,US,CT,Stamford,Bandcamp artist: sahelsounds,sahelsounds.bandcamp.com/album/music-from-saharan-cellphones-volume-2
20,1/4/20 11:04am,Bandcamp,album,Houmeissa,Hama,USD,7.0,1.0,,7.0,,,,0.4,paypal,7.0,0.0,1734504905,,0.7,0.7,0.0,5.9,61.24,5.9,digital download,,http://hamasynth.bandcamp.com/album/houmeissa,,SS-049,656605 382364,,Christopher Miller,robertbrown@norris.com,6972827077,,Erin Russell,4718 Thompson Rapid Suite 305,,,,,,,,,United States,US,NJ,Somerville,,
21,1/4/20 3:47pm,Bandcamp,album,Ilana: The Creator,Mdou Moctar,USD,7.0,1.0,,7.0,1.4,,,0.54,paypal,8.4,0.0,1624271293,,0.7,0.7,0.0,5.76,67.0,5.76,digital download,,http://mdoumoctar.bandcamp.com/album/ilana-the-creator,,SS-051,602318 136893,,Jeremy Rogers,ejones@bailey-butler.biz,8362006447,,Grace Mcintosh,10324 Joseph Tunnel,,,,,,,,,United Kingdom,GB,Bristol,Bristol,rateyourmusic.com,rateyourmusic.com/release/album/mdou-moctar/ilana-the-creator/
22,1/4/20 6:03pm,shop@sahelsounds.com,payout,,,USD,,,,,,,,0.37,transfer,36.84,36.47,t248785974,9JL54016ES172881V,,,,-36.84,30.16,,,,,,,,,,,,,,,,,,,,,,,,,,,,
23,1/4/20 7:48pm,Bandcamp,album,Ilana: The Creator,Mdou Moctar,USD,7.0,1.0,,7.0,,,,0.4,credit card,7.0,0.0,3270726597,,0.7,0.7,0.0,5.9,36.06,5.9,digital download,,http://mdoumoctar.bandcamp.com/album/ilana-the-creator,,SS-051,602318 136893,,Jason Spencer,qthomas@hotmail.com,+1-867-350-1347,,Dustin Bryan,39912 Kelly Causeway Apt. 176,,,,,,,,,United States,US,CA,Hercules,Bandcamp search,bandcamp.com/autocomplete-search
24,1/4/20 7:52pm,Bandcamp,package,Anou Malane,Abdallah Ag Oumbadougou,USD,10.0,1.0,,10.0,,4.0,United States,0.61,credit card,14.0,0.0,2489423601,,1.0,1.0,0.0,12.39,48.45,8.39,Limited Edition Cassette,,http://abdallahagoumbadougou.bandcamp.com/album/anou-malane,SS-053cass,SS-053,602318 136992,,Robert Osborne,nancy06@hotmail.com,(402)413-0166x5008,,Matthew Aguirre,84347 Ramirez Mission,,New York,NY,10009,United States,US,1/7/20,,United States,US,NY,New York,Google search,www.google.com/
25,1/4/20 8:15pm,Bandcamp,album,Anou Malane,Abdallah Ag Oumbadougou,USD,7.0,1.0,,7.0,,,,0.4,gift card,7.0,0.0,296854418,,0.7,0.7,0.0,5.9,54.35,5.9,digital download,,http://abdallahagoumbadougou.bandcamp.com/album/anou-malane,,SS-053,602318 136992,,Luke Nelson,xpayne@yahoo.com,961.330.7657x01472,,Jason Oconnor,754 Barnes Meadows,,,,,,,,,United States,US,IL,Chicago,,
26,1/4/20 10:23pm,Bandcamp,package,Sahel Sounds Label Sampler,Various Artists,USD,20.0,1.0,,20.0,,5.0,United States,0.78,paypal,25.0,0.0,3970625947,,2.0,2.0,0.0,22.22,76.57,17.22,Sahel Sounds t-shirt,XL,http://sahelsounds.bandcamp.com/merch/sahel-sounds-t-shirt,SS-T01-BLK-UXL,,,,Kelly Saunders,nicholas32@tanner-rodriguez.info,206.260.8791,,Brian Roach,7585 Ashley Ferry Apt. 039,Suite 103 - Box 346,Tempe,AZ,85284,United States,US,1/7/20,,United States,US,AZ,Tempe,Bandcamp search,bandcamp.com/autocomplete-search
27,1/5/20 1:56am,Bandcamp,album,Music from Saharan Cellphones,Various,USD,7.0,1.0,,7.0,,,,0.47,paypal,7.0,0.0,1968743040,,0.7,0.7,0.0,5.83,82.4,5.83,digital download,,http://sahelsounds.bandcamp.com/album/music-from-saharan-cellphones,,SS-003,889326 667889,,Jacqueline Guerrero,amberperry@mills.info,533-543-1426,,Steven Davis,59944 Mayo Mountain Suite 212,,,,,,,,,Australia,AU,NSW,Sydney,,
28,1/5/20 3:57am,Bandcamp,album,La Musique Electronique du Niger,Mamman Sani,USD,7.0,1.0,,7.0,,,,0.47,credit card,7.0,0.0,251252605,,0.7,0.7,0.0,5.83,88.23,5.83,digital download,,http://mammansani.bandcamp.com/album/la-musique-electronique-du-niger,,SS-011,889326 664864,,Sheila Black,matthew68@collier.biz,+1-464-753-5913x390,,Edward Roberts,22257 Albert Harbors,,,,,,,,,Canada,CA,BC,Vancouver,Bandcamp Discover,bandcamp.com/#discover
29,1/5/20 4:01am,Bandcamp,album,Ilana: The Creator,Mdou Moctar,USD,7.0,1.0,,7.0,1.4,,,0.54,paypal,8.4,0.0,1132723532,,0.7,0.7,0.0,5.76,93.99,5.76,digital download,,http://mdoumoctar.bandcamp.com/album/ilana-the-creator,,SS-051,602318 136893,,Joseph Smith,jonesdeborah@williams.org,001-813-435-3526x428,,Javier Mason,99715 Ryan Field,,,,,,,,,United Kingdom,GB,East Sussex,Seaford,Bandcamp home page,bandcamp.com/
30,1/5/20 4:14am,Bandcamp,album,Unreleased Tapes 1981-1984,Mamman Sani,USD,7.0,1.0,,7.0,,,,0.47,credit card,7.0,0.0,2551805403,,0.7,0.7,0.0,5.83,99.82,5.83,digital download,,http://mammansani.bandcamp.com/album/unreleased-tapes-1981-1984,,SS-030,889326 667568,,Andrew Robinson,edwardsjulian@hotmail.com,+1-220-564-2352x186,,Laura Thompson,10373 Danielle Camp Suite 481,,,,,,,,,Australia,AU,NSW,Sydney,,
31,1/5/20 7:03am,Bandcamp,album,Ilana: The Creator,Mdou Moctar,USD,7.0,1.0,,7.0,,,,0.4,paypal,7.0,0.0,1423359174,,0.7,0.7,0.0,5.9,105.72,5.9,digital download,,http://mdoumoctar.bandcamp.com/album/ilana-the-creator,,SS-051,602318 136893,,James Schwartz,anne65@hunter-donaldson.com,(655)584-3812x653,,Alexander Stewart,327 Juarez Way Apt. 097,,,,,,,,,United States,US,NY,Brooklyn,Bandcamp Daily: mdou-moctar-ilana-the-creator-review,daily.bandcamp.com/album-of-the-day/mdou-moctar-ilana-the-creator-review
32,1/5/20 10:31am,Bandcamp,album,Ilana: The Creator,Mdou Moctar,USD,7.0,1.0,,7.0,1.33,,,0.54,paypal,8.33,0.0,3892489014,,0.7,0.7,0.0,5.76,111.48,5.76,digital download,,http://mdoumoctar.bandcamp.com/album/ilana-the-creator,,SS-051,602318 136893,,Savannah Martin,emason@hotmail.com,117-325-5904x5019,,Catherine Floyd,894 Ayala Tunnel Apt. 471,,,,,,,,,Germany,DE,Bavaria,Munich,,
33,1/5/20 11:44am,Bandcamp,album,Anou Malane,Abdallah Ag Oumbadougou,USD,30.0,1.0,,30.0,1.4,,,1.21,paypal,31.4,0.0,3616979343,,3.0,3.0,0.0,25.79,137.27,25.79,digital download,,http://abdallahagoumbadougou.bandcamp.com/album/anou-malane,,SS-053,602318 136992,,Timothy Huerta,lvaldez@hancock.com,339.711.9827x43527,,Ryan Harris,89530 Wood Parks Suite 019,,,,,,,,,United Kingdom,GB,,,,
34,1/5/20 1:16pm,Bandcamp,package,Anou Malane,Abdallah Ag Oumbadougou,USD,17.0,2.0,,34.0,,24.0,United States,2.16,credit card,58.0,0.0,2058287163,,3.4,3.4,0.0,52.44,189.71,28.44,Vinyl,,http://abdallahagoumbadougou.bandcamp.com/album/anou-malane,SS-053lp,SS-053,602318 136992,,Ashley Vasquez,vbrown@gentry-kim.com,435-516-6968x204,,Christine Ramos,2703 Smith Dale,Kelmarsh,Northants,,NN6 9NA,United Kingdom,GB,1/7/20,,United Kingdom,GB,,Northants,Google search,www.google.co.uk/
35,1/5/20 3:42pm,Bandcamp,package,Ilana: The Creator,Mdou Moctar,USD,17.0,1.0,,17.0,,5.0,United States,0.72,paypal,22.0,0.0,4211577311,,1.7,1.7,0.0,19.58,209.29,14.58,Ilana LP,,http://mdoumoctar.bandcamp.com/album/ilana-the-creator,SS-051lp,SS-051,602318 136893,,Jessica Smith,mahoneybrett@padilla.com,001-597-396-0494,,Nancy Wang,970 Thornton Cliffs Apt. 295,,West Deptford,NJ,8086,United States,US,1/7/20,,United States,US,NJ,West Deptford,Google search,www.google.com/
36,1/5/20 3:46pm,Bandcamp,package,Uchronia – Field Recordings From Alternate Realities,Sahel Sounds,USD,7.0,1.0,,7.0,,20.0,United States,1.16,credit card,27.0,0.0,3167999794,,0.7,0.7,0.0,25.14,234.43,5.14,Uchronia – Field Recordings From Alternate Realities photo book,,http://sahelsounds.bandcamp.com/merch/uchronia-field-recordings-from-alternate-realities-photo-book,SS-000book,,,,Eugene Soto,jacksonapril@yahoo.com,(779)560-6253,,Priscilla Johnson,555 Joseph Glen Apt. 365,,Callaghan,NSW,2308,Australia,AU,1/7/20,,Australia,AU,NSW,Callaghan,Bandcamp fan wishlist,bandcamp.com/felix_gif
37,1/5/20 6:02pm,shop@sahelsounds.com,payout,,,USD,,,,,,,,0.24,transfer,24.4,24.16,t249000674,4R647661XM4137056,,,,-24.4,210.03,,,,,,,,,,,,,,,,,,,,,,,,,,,,
38,1/5/20 6:02pm,shop@sahelsounds.com,payout,,,USD,,,,,,,,0.06,transfer,5.76,5.7,t249000677,3SF40137MC358843L,,,,-5.76,204.27,,,,,,,,,,,,,,,,,,,,,,,,,,,,
39,1/5/20 8:24pm,Bandcamp,album,Abba Gargando,Abba Gargando,USD,7.0,1.0,,7.0,1.4,,,0.54,paypal,8.4,0.0,1667253191,,0.7,0.7,0.0,5.76,210.03,5.76,digital download,,http://abbagargando.bandcamp.com/album/abba-gargando,,SS-029,889326 664888,,Alexander Marks,littleian@hood.com,001-736-087-9871x514,,Rodney Rogers,90454 Brennan Hills Apt. 073,,,,,,,,,United Kingdom,GB,Nottingham,Nottingham,Bandcamp fan wishlist,bandcamp.com/christree1977
40,1/5/20 11:28pm,Bandcamp,package,Akounak Tedalat Taha Tazoughai OST,Mdou Moctar,USD,17.0,1.0,,17.0,,5.0,United States,1.08,paypal,22.0,0.0,1937430143,,1.7,0.0,1.7,0.0,210.03,14.22,Akounak OST LP,,http://mdoumoctar.bandcamp.com/album/akounak-tedalat-taha-tazoughai-ost,SS-028lp-1,SS-028,889326 667599,,Hannah Mueller,nicole82@yahoo.com,(981)314-1169x39620,,Ronald Williams,225 Natalie Trace,,santa fe,NM,87592,United States,US,1/7/20,,United States,US,NM,santa fe,duckduckgo.com,duckduckgo.com/
41,1/5/20 11:28pm,Bandcamp,package,Afelan,Mdou Moctar,USD,17.0,1.0,,17.0,,2.0,United States,,,19.0,0.0,1937430143,,1.7,3.4,0.0,36.52,246.55,15.3,Afelan LP,,http://mdoumoctar.bandcamp.com/album/afelan,SS-017lp,SS-017,889326 664840,,Hannah Mueller,jacobsdavid@allen-santos.org,+1-945-270-8158,,Lisa Dorsey,445 Sherri Dam Apt. 496,,santa fe,NM,87592,United States,US,1/7/20,,United States,US,NM,santa fe,duckduckgo.com,duckduckgo.com/
42,1/6/20 1:39am,Bandcamp,album,Eghass Malan,Les Filles de Illighadad,USD,7.0,1.0,,7.0,,,,0.47,credit card,7.0,0.0,3179361040,,0.7,0.7,0.0,5.83,252.38,5.83,digital download,,http://lesfillesdeillighadad.bandcamp.com/album/eghass-malan,,SS-044,191515 928351,,David Nelson,waltonhelen@hotmail.com,295-525-7869,,Brandon Espinoza,7438 Joseph Road,,,,,,,,,Australia,AU,VIC,Melbourne,Recommendations footer: artist recommendation,bandcamp.com/footer/ar/a3681570634
43,1/6/20 3:23am,Bandcamp,album,Eghass Malan,Les Filles de Illighadad,USD,7.0,1.0,,7.0,,,,0.4,credit card,7.0,0.0,2396847132,,0.7,0.7,0.0,5.9,258.28,5.9,digital download,,http://lesfillesdeillighadad.bandcamp.com/album/eghass-malan,,SS-044,191515 928351,,Sheryl Hayes,todd38@prince.net,001-589-153-0240,,Joseph Taylor,484 Michael Villages Apt. 826,,,,,,,,,United States,US,CA,Los Gatos,,
44,1/6/20 5:24am,Bandcamp,album,Houmeissa,Hama,USD,7.0,1.0,,7.0,,,,0.4,paypal,7.0,0.0,1533809260,,0.7,0.7,0.0,5.9,264.18,5.9,digital download,,http://hamasynth.bandcamp.com/album/houmeissa,,SS-049,656605 382364,,Amber Ross,matthewnelson@hotmail.com,(439)077-6964,,Travis Martinez,92801 Pennington Run,,,,,,,,,United States,US,VA,Ashburn,Bandcamp Daily (embedded player): bandcamp-essential-releases-january-18-2018,daily.bandcamp.com/2019/01/18/bandcamp-essential-releases-january-18-2018/
45,1/6/20 11:39am,Bandcamp,package,Uchronia – Field Recordings From Alternate Realities,Sahel Sounds,USD,7.0,1.0,,7.0,,4.0,United States,0.51,paypal,11.0,0.0,1227566407,,0.7,0.7,0.0,9.79,273.97,5.79,Uchronia – Field Recordings From Alternate Realities photo book,,http://sahelsounds.bandcamp.com/merch/uchronia-field-recordings-from-alternate-realities-photo-book,SS-000book,,,,Peter Nichols,egeorge@yahoo.com,+1-033-676-5108,,Margaret Flores,986 Debra Road,,Bordentown,NJ,8505,United States,US,1/7/20,,United States,US,NJ,Bordentown,,
46,1/6/20 4:12pm,Bandcamp,album,Music from Saharan Cellphones,Various,USD,7.0,1.0,,7.0,1.47,,,0.55,paypal,8.47,0.0,4270334326,,0.7,0.7,0.0,5.75,279.72,5.75,digital download,,http://sahelsounds.bandcamp.com/album/music-from-saharan-cellphones,,SS-003,889326 667889,,Kelli Cruz,jeffrey47@hubbard-fowler.org,9361430833,,Cory Shepard,7917 Aguirre Mountain Suite 884,,,,,,,,,Spain,ES,Zamora,Zamora,Google search,www.google.com/
47,1/6/20 6:03pm,shop@sahelsounds.com,payout,,,USD,,,,,,,,1.75,transfer,174.98,173.23,t249225035,3A303267HF365590V,,,,-174.98,104.74,,,,,,,,,,,,,,,,,,,,,,,,,,,,
48,1/6/20 6:03pm,shop@sahelsounds.com,payout,,,USD,,,,,,,,0.29,transfer,29.29,29.0,t249225036,8ED5856227494100C,,,,-29.29,75.45,,,,,,,,,,,,,,,,,,,,,,,,,,,,
49,1/6/20 7:15pm,Bandcamp,package,Ilana: The Creator,Mdou Moctar,USD,20.0,1.0,,20.0,,5.0,United States,0.78,paypal,25.0,0.0,3770368761,,2.0,2.0,0.0,22.22,97.67,17.22,Ilana LP,,http://mdoumoctar.bandcamp.com/album/ilana-the-creator,SS-051lp,SS-051,602318 136893,,James Walker,inichols@hotmail.com,+1-254-302-9190x705,,Renee Turner,99763 Williams Vista,,Mission Viejo,CA,92692,United States,US,1/7/20,,United States,US,CA,Mission Viejo,,
50,1/6/20 8:03pm,Bandcamp,album,Ilana: The Creator,Mdou Moctar,USD,10.0,1.0,,10.0,1.33,,,1.29,paypal,11.33,0.0,1190096259,,1.0,0.0,1.0,0.0,97.67,7.71,digital download,,http://mdoumoctar.bandcamp.com/album/ilana-the-creator,,SS-051,602318 136893,,Douglas Coleman,huffcameron@hotmail.com,104.305.9533x18357,,Edward West,67467 Katie Ridge,,,,,,,,,Germany,DE,North Rhine-Westphalia,Siegen,Bandcamp artist: mdoumoctar,mdoumoctar.bandcamp.com
51,1/6/20 8:03pm,Bandcamp,album,Sousoume Tamachek,Mdou Moctar,USD,10.0,1.0,,10.0,1.33,,,,,11.33,0.0,1190096259,,1.0,0.0,2.0,0.0,97.67,9.0,digital download,,http://mdoumoctar.bandcamp.com/album/sousoume-tamachek,,SS-043,191515 769435,,Douglas Coleman,jasminejones@mack.com,124.339.9352x58206,,Meghan Butler,45799 Stacy Skyway,,,,,,,,,Germany,DE,North Rhine-Westphalia,Siegen,Bandcamp artist: mdoumoctar,mdoumoctar.bandcamp.com
52,1/6/20 8:03pm,Bandcamp,album,Akounak Tedalat Taha Tazoughai OST,Mdou Moctar,USD,10.0,1.0,,10.0,1.33,,,,,11.33,0.0,1190096259,,1.0,3.0,0.0,25.71,123.38,9.0,digital download,,http://mdoumoctar.bandcamp.com/album/akounak-tedalat-taha-tazoughai-ost,,SS-028,889326 667599,,Douglas Coleman,ppierce@castro-williams.com,713.195.9497x17948,,William Hopkins,057 Powell Heights Apt. 454,,,,,,,,,Germany,DE,North Rhine-Westphalia,Siegen,Bandcamp artist: mdoumoctar,mdoumoctar.bandcamp.com
53,1/6/20 8:21pm,Bandcamp,album,Ilana: The Creator,Mdou Moctar,USD,7.0,1.0,,7.0,,,,0.4,paypal,7.0,0.0,2111585099,,0.7,0.7,0.0,5.9,129.28,5.9,digital download,,http://mdoumoctar.bandcamp.com/album/ilana-the-creator,,SS-051,602318 136893,,James Gregory,cjackson@hotmail.com,5290104118,,Justin Conner,78110 Shepard Terrace,,,,,,,,,United States,US,NY,New York,Google search,www.google.com/
54,1/7/20 12:11am,Bandcamp,album,Music from Saharan Cellphones,Various,USD,7.0,1.0,,7.0,,,,0.4,credit card,7.0,0.0,3704492819,,0.7,0.7,0.0,5.9,135.18,5.9,digital download,,http://sahelsounds.bandcamp.com/album/music-from-saharan-cellphones,,SS-003,889326 667889,,Rebecca Manning,jonathan37@gray.net,699.788.4026,,Glenn Thomas,857 Yates Loop Suite 725,,,,,,,,,United States,US,MI,Delton,t.umblr.com,t.umblr.com/
55,1/7/20 2:21am,Bandcamp,album,Music from Saharan Cellphones,Various,USD,7.0,1.0,,7.0,,,,0.4,credit card,7.0,0.0,834140529,,0.7,0.7,0.0,5.9,141.08,5.9,digital download,,http://sahelsounds.bandcamp.com/album/music-from-saharan-cellphones,,SS-003,889326 667889,,David Brown,trevordeleon@gmail.com,999.323.7426x7040,,Nicole Sanders,808 Rodriguez Causeway Suite 053,,,,,,,,,United States,US,CA,Riverside,,
56,1/7/20 5:29am,Bandcamp,package,Ilana: The Creator,Mdou Moctar,USD,12.0,1.0,,12.0,,3.0,United States,0.59,paypal,15.0,0.0,580129097,,1.2,1.2,0.0,13.21,154.29,10.21,Ilana: The Creator CD,,http://mdoumoctar.bandcamp.com/album/ilana-the-creator,SS-051cd,SS-051,602318 136893,,Ricardo Wilson,taylorbarnes@howard.com,(280)145-5477,,Ashley Burton,8513 Crystal Heights,,Bellingham,WA,98225,United States,US,1/7/20,,United States,US,WA,Bellingham,Google search,www.google.com/
57,1/7/20 1:44pm,Bandcamp,album,Ilana: The Creator,Mdou Moctar,USD,7.0,1.0,,7.0,1.33,,,0.57,credit card,8.33,0.0,3220833699,,0.7,0.7,0.0,5.73,160.02,5.73,digital download,,http://mdoumoctar.bandcamp.com/album/ilana-the-creator,,SS-051,602318 136893,,Julie Guzman,staceymurray@charles-clark.com,588-657-8362x100,,Elaine Armstrong,37492 Sherri Station,,,,,,,,,Germany,DE,Land Berlin,Berlin,Bandcamp search,bandcamp.com/autocomplete-search
58,1/7/20 5:57pm,Bandcamp,package,Les Filles de Illighadad,Les Filles de Illighadad,USD,45.0,1.0,,45.0,,5.0,United States,1.44,paypal,50.0,0.0,1730397136,,4.5,0.0,4.5,0.0,160.02,39.06,Les Filles de Illighadad LP,,http://lesfillesdeillighadad.bandcamp.com/album/les-filles-de-illighadad,SS-033-LP,SS-033,889326 664918,,Susan Henderson,bharris@yahoo.com,001-933-107-9944x8379,,Jacob Garcia,7915 Kenneth Ville Apt. 924,,Louisville,KY,40206,United States,US,1/7/20,,United States,US,KY,Louisville,,
59,1/7/20 5:57pm,Bandcamp,album,Les Filles de Illighadad,Les Filles de Illighadad,USD,10.0,1.0,,10.0,,,,,,10.0,0.0,1730397136,,1.0,5.5,0.0,53.06,213.08,9.0,digital download,,http://lesfillesdeillighadad.bandcamp.com/album/les-filles-de-illighadad,,SS-033,889326 664918,,Susan Henderson,jacobsmith@cochran-harris.com,024.699.5251x23403,,Adam Oneill,94145 Corey Spur,,Louisville,KY,40206,,,,,United States,US,KY,Louisville,,
60,1/7/20 6:02pm,shop@sahelsounds.com,payout,,,USD,,,,,,,,0.58,transfer,57.82,57.24,t249453772,2VS78730S0409511H,,,,-57.82,155.26,,,,,,,,,,,,,,,,,,,,,,,,,,,,
61,1/7/20 6:03pm,shop@sahelsounds.com,payout,,,USD,,,,,,,,0.18,transfer,17.63,17.45,t249453773,67K84594YH342901F,,,,-17.63,137.63,,,,,,,,,,,,,,,,,,,,,,,,,,,,
62,1/7/20 6:48pm,Bandcamp,package,Ilana: The Creator,Mdou Moctar,USD,8.0,1.0,,8.0,,4.0,United States,0.56,credit card,12.0,0.0,485823553,,0.8,0.8,0.0,10.64,148.27,6.64,Ilana: The Creator cassette,,http://mdoumoctar.bandcamp.com/album/ilana-the-creator,SS-028cs,SS-051,602318 136893,,Megan Pitts,ecampbell@hunter.com,715-139-8768,,Megan Ward,607 Hardin Lights Suite 097,,St. Louis,MO,63117,United States,US,,,United States,US,MO,St. Louis,Google search,www.google.com/
63,1/7/20 8:30pm,Bandcamp,album,Takamba WhatsApp 2018 EP,Tallawit Timbouctou,USD,5.0,1.0,,5.0,,,,0.56,credit card,5.0,0.0,2925948488,,0.5,0.0,0.5,0.0,148.27,3.94,digital download,,http://tallawit.bandcamp.com/album/takamba-whatsapp-2018-ep,,SS-056,602318 137098,,Kenneth Harris,ymorris@sutton.info,001-272-974-9600x475,,Rachel Scott,98993 Kelley Union,,,,,,,,,United States,US,CA,Costa Mesa,,
64,1/7/20 8:30pm,Bandcamp,album,Eghass Malan,Les Filles de Illighadad,USD,7.0,1.0,,7.0,,,,,,7.0,0.0,2925948488,,0.7,1.2,0.0,10.24,158.51,6.3,digital download,,http://lesfillesdeillighadad.bandcamp.com/album/eghass-malan,,SS-044,191515 928351,,Kenneth Harris,richard15@hotmail.com,5356172943,,Mark Robinson,522 Yu Centers,,,,,,,,,United States,US,CA,Costa Mesa,,
65,1/7/20 9:09pm,Bandcamp,package,Ilana: The Creator,Mdou Moctar,USD,20.0,1.0,,20.0,,5.0,United States,0.85,credit card,25.0,0.0,1640180674,,2.0,2.0,0.0,22.15,180.66,17.15,Ilana LP,,http://mdoumoctar.bandcamp.com/album/ilana-the-creator,SS-051lp,SS-051,602318 136893,,Carla Ryan,carterjill@harrington.com,703-377-3034x32982,,Charles Garcia,541 William Overpass Apt. 618,,Pewaukee,WI,53072,United States,US,1/7/20,,United States,US,WI,Pewaukee,Google search,www.google.com/
66,1/7/20 11:47pm,Bandcamp,album,Music from Saharan Cellphones,Various,USD,7.0,1.0,,7.0,,,,0.4,credit card,7.0,0.0,2792792601,,0.7,0.7,0.0,5.9,186.56,5.9,digital download,,http://sahelsounds.bandcamp.com/album/music-from-saharan-cellphones,,SS-003,889326 667889,,Christopher Robinson,lopezjohn@fry-moore.com,+1-421-635-7425,,Jessica Tate,4759 Jenkins Pass Apt. 732,,,,,,,,,United States,US,MA,Wareham,,
67,1/8/20 12:01am,Bandcamp,package,Sahel Sounds Label Sampler,Various Artists,USD,20.0,1.0,,20.0,,15.0,United States,1.32,paypal,35.0,0.0,2331850376,,2.0,2.0,0.0,31.68,218.24,16.68,Sahel Sounds t-shirt,Medium,http://sahelsounds.bandcamp.com/merch/sahel-sounds-t-shirt,SS-T01-BLK-UMD,,,,Aaron Turner,mary89@rice.com,912.235.5273x44231,,Monica Robles,5867 Michelle Burg Suite 146,,Leipzig,,4105,Germany,DE,1/14/20,,Germany,DE,,Leipzig,,
68,1/8/20 3:23am,Bandcamp,album,Ilana: The Creator,Mdou Moctar,USD,7.0,1.0,,7.0,,,,0.4,paypal,7.0,0.0,1518195584,,0.7,0.7,0.0,5.9,224.14,5.9,digital download,,http://mdoumoctar.bandcamp.com/album/ilana-the-creator,,SS-051,602318 136893,,Melissa Franklin,brentflores@garcia-kelley.com,(194)196-3728x4726,,Lisa Smith,05628 Burke Vista Suite 761,,,,,,,,,United States,US,VA,,Bandcamp artist: sunburnedhandoftheman,sunburnedhandoftheman.bandcamp.com/album/no-magic-man
69,1/8/20 3:31am,Bandcamp,album,Houmeissa,Hama,USD,7.0,1.0,,7.0,,,,0.4,paypal,7.0,0.0,4138154925,,0.7,0.7,0.0,5.9,230.04,5.9,digital download,,http://hamasynth.bandcamp.com/album/houmeissa,,SS-049,656605 382364,,Raven Woods,etran@parrish.biz,(430)379-8607,,Jeanne Gonzalez,90725 Katherine Fall,,,,,,,,,United States,US,WA,Puyallup,noweidzieodmorza.com (embedded player),noweidzieodmorza.com/en/12031-tuareg-disco-and-electronic-cumbia/
70,1/8/20 4:30am,Bandcamp,package,Ilana: The Creator,Mdou Moctar,USD,12.0,1.0,,12.0,,10.0,United States,1.0,credit card,22.0,0.0,2775170370,,1.2,1.2,0.0,19.8,249.84,9.8,Ilana: The Creator CD,,http://mdoumoctar.bandcamp.com/album/ilana-the-creator,SS-051cd,SS-051,602318 136893,,Richard Johnson,whubbard@smith.com,802-050-4068x799,,Angela Olsen,72346 Stewart Squares Suite 374,Montaillon,Aigondigné,,79370,France,FR,1/14/20,,France,FR,,Aigondigné,,
71,1/8/20 4:56am,Bandcamp,album,Ilana: The Creator,Mdou Moctar,USD,7.0,1.0,,7.0,,,,0.4,credit card,7.0,0.0,439280446,,0.7,0.7,0.0,5.9,255.74,5.9,digital download,,http://mdoumoctar.bandcamp.com/album/ilana-the-creator,,SS-051,602318 136893,,Johnathan White,virginianavarro@yahoo.com,001-389-427-6808x936,,Allison Garza,80352 Mcdonald Flat,,,,,,,,,United States,US,NY,New York,Google search,www.google.com/
72,1/8/20 11:11am,Bandcamp,package,Ilana: The Creator,Mdou Moctar,USD,17.0,1.0,,17.0,,20.0,United States,1.48,credit card,37.0,0.0,663153627,,1.7,1.7,0.0,33.82,289.56,13.82,Ilana LP,,http://mdoumoctar.bandcamp.com/album/ilana-the-creator,SS-051lp,SS-051,602318 136893,,Cheryl Martinez,kelseybell@hotmail.com,001-041-430-3580,,Brandon Marshall,5700 Susan Burg Suite 807,,Gdańsk,Pomorskie,80-322,Poland,PL,1/14/20,,Poland,PL,Pomorskie,Gdańsk,Bandcamp search: “mdou moctar”,bandcamp.com/search?q=Mdou%20Moctar
73,1/8/20 12:20pm,Bandcamp,album,Tiris,El Wali,USD,7.0,1.0,,7.0,1.61,,,0.55,paypal,8.61,0.0,2442124056,,0.7,0.7,0.0,5.75,295.31,5.75,digital download,,http://elwali.bandcamp.com/album/tiris,,SS-055,602318 136923,,Vincent Sanchez,qstewart@yahoo.com,+1-036-957-3696x75041,"Thanks for wonderfull music, best wishes from Poland",Anthony Andersen,6400 Elizabeth Knoll Suite 857,,,,,,,,,Poland,PL,Greater Poland,Poznan,smarturl.it,smarturl.it/elwalitiris
74,1/8/20 3:02pm,Bandcamp,album,Les Filles de Illighadad,Les Filles de Illighadad,USD,7.0,1.0,,7.0,,,,0.47,paypal,7.0,0.0,3509363126,,0.7,0.7,0.0,5.83,301.14,5.83,digital download,,http://lesfillesdeillighadad.bandcamp.com/album/les-filles-de-illighadad,,SS-033,889326 664918,,Megan Carr,reginald06@beasley.biz,967-090-8612x637,,Carol Wells,231 Calhoun Junction,,,,,,,,,Switzerland,CH,Bern,Bern,youtube.com,www.youtube.com/
75,1/8/20 3:04pm,Bandcamp,album,Les Filles de Illighadad,Les Filles de Illighadad,USD,7.0,1.0,,7.0,,,,0.4,paypal,7.0,0.0,4026407978,,0.7,0.7,0.0,5.9,307.04,5.9,digital download,,http://lesfillesdeillighadad.bandcamp.com/album/les-filles-de-illighadad,,SS-033,889326 664918,,Katie Lopez,kfreeman@collins-richardson.net,512-867-1209,,Bryce Lee,81055 Rodriguez Villages,,,,,,,,,United States,US,GA,Athens,Bandcamp fan wishlist,bandcamp.com/scottcreney
76,1/8/20 3:06pm,Bandcamp,album,Sahel Sounds Label Sampler,Various Artists,USD,1.0,1.0,,1.0,,,,0.1,credit card,1.0,0.0,3528986191,,0.1,0.1,0.0,0.8,307.84,0.8,digital download,,http://sahelsounds.bandcamp.com/album/sahel-sounds-label-sampler,,SS-058,602318 137111,,Katie Lopez,daltonsarah@rivera.biz,723-339-1760,,Jared Johnson,9447 Brown Common Suite 491,,,,,,,,,United States,US,GA,Athens,bandcamp.com,bandcamp.com
77,1/8/20 3:24pm,Bandcamp,album,Abba Gargando,Abba Gargando,USD,7.0,1.0,,7.0,,,,0.4,credit card,7.0,0.0,2217441811,,0.7,0.7,0.0,5.9,313.74,5.9,digital download,,http://abbagargando.bandcamp.com/album/abba-gargando,,SS-029,889326 664888,,Holly Hill,jthomas@york.com,364-396-3511x674,,Amy Clark,027 Robert Shoals,,,,,,,,,United States,US,CA,San Diego,Bandcamp fan wishlist,bandcamp.com/sleezsisters
78,1/8/20 5:11pm,Bandcamp,package,Ilana: The Creator,Mdou Moctar,USD,20.0,1.0,,20.0,,5.0,United States,0.85,credit card,25.0,0.0,172215775,,2.0,2.0,0.0,22.15,335.89,17.15,Ilana LP,,http://mdoumoctar.bandcamp.com/album/ilana-the-creator,SS-051lp,SS-051,602318 136893,,Katherine Butler,ffigueroa@mccarthy.com,850.722.3620,,Thomas Reeves,3651 Kevin Road Suite 802,,Alameda,CA,94501,United States,US,1/14/20,,United States,US,CA,Alameda,Google search,www.google.com/
79,1/8/20 5:16pm,Bandcamp,album,Anou Malane,Abdallah Ag Oumbadougou,USD,7.0,1.0,,7.0,,,,0.47,paypal,7.0,0.0,2366067448,,0.7,0.7,0.0,5.83,341.72,5.83,digital download,,http://abdallahagoumbadougou.bandcamp.com/album/anou-malane,,SS-053,602318 136992,,Jessica Carlson,maria25@yahoo.com,+1-093-719-0693x69556,,Diana Perkins,1916 Corey Summit,,,,,,,,,Canada,CA,QC,Montreal,Google search,www.google.com/
80,1/8/20 5:54pm,Bandcamp,album,Ilana: The Creator,Mdou Moctar,USD,7.0,1.0,,7.0,,,,0.4,credit card,7.0,0.0,2340191758,,0.7,0.7,0.0,5.9,347.62,5.9,digital download,,http://mdoumoctar.bandcamp.com/album/ilana-the-creator,,SS-051,602318 136893,,Alan Taylor,qhale@alexander.com,912.733.8603,,Tamara Powell,23548 Carlson Shoal,,,,,,,,,United States,US,AZ,Phoenix,Bandcamp home page,bandcamp.com/
81,1/8/20 6:02pm,shop@sahelsounds.com,payout,,,USD,,,,,,,,1.2,transfer,119.93,118.73,t249682553,0B101251FX406402W,,,,-119.93,227.69,,,,,,,,,,,,,,,,,,,,,,,,,,,,
82,1/8/20 6:02pm,shop@sahelsounds.com,payout,,,USD,,,,,,,,0.18,transfer,17.7,17.52,t249682546,2J4410888S470472X,,,,-17.7,209.99,,,,,,,,,,,,,,,,,,,,,,,,,,,,
83,1/8/20 6:50pm,Bandcamp,refund,Ilana: The Creator,Mdou Moctar,USD,8.0,-1.0,,-8.0,,-4.0,United States,-0.56,credit card,-12.0,,t249475596,,-0.8,-0.8,0.0,-10.64,199.35,,Ilana: The Creator cassette,,http://mdoumoctar.bandcamp.com/album/ilana-the-creator,SS-028cs,SS-051,602318 136893,,Megan Pitts,andreamurphy@bender.com,+1-019-664-3889x738,,Edward Valencia,001 Marissa Trail Apt. 696,,St. Louis,MO,63117,United States,US,,,United States,US,MO,St. Louis,Google search,www.google.com/
84,1/8/20 7:52pm,Bandcamp,package,Eghass Malan,Les Filles de Illighadad,USD,17.0,1.0,,17.0,,17.0,United States,1.29,paypal,34.0,0.0,3149773712,,1.7,1.7,0.0,31.01,230.36,14.01,'Eghass Malan' LP,,http://lesfillesdeillighadad.bandcamp.com/album/eghass-malan,SS-044lp-1,SS-044,191515 928351,,James Perry,elizabethcunningham@banks-jones.com,(333)035-0302x64818,,Patrick Valdez,878 Rebekah Loop Suite 490,,Kitchener,ON,N2E3L7,Canada,CA,1/14/20,,Canada,CA,ON,Kitchener,rateyourmusic.com (embedded player),rateyourmusic.com/release/album/les-filles-de-illighadad/eghass-malan/
85,1/8/20 7:55pm,Bandcamp,album,Eghass Malan,Les Filles de Illighadad,USD,7.0,1.0,,7.0,1.4,,,0.54,paypal,8.4,0.0,4057087888,,0.7,0.7,0.0,5.76,236.12,5.76,digital download,,http://lesfillesdeillighadad.bandcamp.com/album/eghass-malan,,SS-044,191515 928351,,Lori Ruiz,kweiss@peters-bishop.com,001-928-217-3989x360,,Lisa Dillon,7956 Stephanie Terrace,,,,,,,,,France,FR,Maine-et-Loire,Angers,,
86,1/8/20 8:47pm,Bandcamp,track,Anou Malane,Abdallah Ag Oumbadougou,USD,1.0,1.0,,1.0,0.2,,,0.12,paypal,1.2,0.0,3349888358,,0.1,0.1,0.0,0.78,236.9,0.78,digital download,,http://abdallahagoumbadougou.bandcamp.com/track/anou-malane,,SS-053,,,Dana Gibson,gregoryyu@mcknight-myers.com,522-062-6581x69013,,Meghan Hernandez,3461 Miller Manor,,,,,,,,,United Kingdom,GB,Hammersmith and Fulham,Shepherds Bush,,
87,1/8/20 9:53pm,Bandcamp,album,Sahel Sounds Label Sampler,Various Artists,USD,1.0,1.0,,1.0,,,,0.11,paypal,1.0,0.0,2123095500,,0.1,0.1,0.0,0.79,237.69,0.79,digital download,,http://sahelsounds.bandcamp.com/album/sahel-sounds-label-sampler,,SS-058,602318 137111,,Carol Anderson,leah15@hotmail.com,(598)393-8034x63455,,Anita Morrison,8455 Reid Valley,,,,,,,,,United Kingdom,GB,Hackney,Hackney,Google search,www.google.co.uk/
88,1/9/20 1:10am,Bandcamp,package,Ilana: The Creator,Mdou Moctar,USD,45.0,1.0,,45.0,,6.0,United States,1.27,paypal,51.0,0.0,2320295181,,4.5,4.5,0.0,45.23,282.92,39.23,Ilana The Creator shirt & LP bundle,LARGE,http://mdoumoctar.bandcamp.com/merch/ilana-the-creator-shirt-lp-bundle,SS-051lp*-T02-W-ULG,,,,Timothy Miller,taylorrobert@curtis.info,001-107-240-1707x7814,,Amy Durham,9811 Nicholas Creek Apt. 503,277 East 1500 North,Orem,UT,84057,United States,US,1/14/20,,United States,US,UT,Orem,Bandcamp search,bandcamp.com/autocomplete-search
89,1/9/20 4:00am,Bandcamp,package,Nouakchott Wedding Songs,Various,USD,12.0,1.0,,12.0,,5.0,United States,0.62,paypal,17.0,0.0,2061788921,,1.2,1.2,0.0,15.18,298.1,10.18,Nouakchott Wedding Songs LP - Warehouse find!,,http://sahelsounds.bandcamp.com/album/nouakchott-wedding-songs,SS-027-LP,SS-027,889326 667797,,Cheyenne Meyers,courtney15@jones-lawson.org,415.141.7495,,Timothy Glover,5799 Gaines Dam,,Los Angeles,CA,90041,United States,US,1/14/20,,United States,US,CA,Los Angeles,Bandcamp search,bandcamp.com/autocomplete-search
90,1/9/20 4:24am,Bandcamp,album,Sousoume Tamachek,Mdou Moctar,USD,7.0,1.0,,7.0,,,,0.4,paypal,7.0,0.0,7209585,,0.7,0.7,0.0,5.9,304.0,5.9,digital download,,http://mdoumoctar.bandcamp.com/album/sousoume-tamachek,,SS-043,191515 769435,,Alexis Carey,armstrongthomas@khan-adams.com,6965481564,,Nicolas Williamson,06953 West Stream,,,,,,,,,United States,US,CA,San Diego,,
91,1/9/20 4:40am,Bandcamp,album,Ilana: The Creator,Mdou Moctar,USD,10.0,1.0,,10.0,,,,1.29,paypal,10.0,0.0,570320528,,1.0,0.0,1.0,0.0,304.0,7.71,digital download,,http://mdoumoctar.bandcamp.com/album/ilana-the-creator,,SS-051,602318 136893,,Alexis Carey,amanda86@munoz.com,1317894744,,Samantha Spencer,8221 Steven Fall Suite 780,,,,,,,,,United States,US,CA,San Diego,bandcamp.com,bandcamp.com
92,1/9/20 4:40am,Bandcamp,album,Akounak Tedalat Taha Tazoughai OST,Mdou Moctar,USD,7.0,1.0,,7.0,,,,,,7.0,0.0,570320528,,0.7,0.0,1.7,0.0,304.0,6.3,digital download,,http://mdoumoctar.bandcamp.com/album/akounak-tedalat-taha-tazoughai-ost,,SS-028,889326 667599,,Alexis Carey,rebecca75@gmail.com,791.337.5910x093,,Dana Combs,8608 Matthew Crescent,,,,,,,,,United States,US,CA,San Diego,bandcamp.com,bandcamp.com
93,1/9/20 4:40am,Bandcamp,album,Anar,Mdou Moctar,USD,7.0,1.0,,7.0,,,,,,7.0,0.0,570320528,,0.7,0.0,2.4,0.0,304.0,6.3,digital download,,http://mdoumoctar.bandcamp.com/album/anar,,SS-024,889326 664857,,Alexis Carey,manuelchavez@hotmail.com,+1-717-781-6664x4335,,Joshua Flynn,2103 Kathleen Pines,,,,,,,,,United States,US,CA,San Diego,bandcamp.com,bandcamp.com
94,1/9/20 4:40am,Bandcamp,album,Afelan,Mdou Moctar,USD,7.0,1.0,,7.0,,,,,,7.0,0.0,570320528,,0.7,0.0,3.1,0.0,304.0,6.3,digital download,,http://mdoumoctar.bandcamp.com/album/afelan,,SS-017,889326 664840,,Alexis Carey,moodykatherine@conner.com,001-265-614-5972x908,,Joseph Jones,1809 Kevin Parkway Apt. 633,,,,,,,,,United States,US,CA,San Diego,bandcamp.com,bandcamp.com
95,1/9/20 4:40am,Bandcamp,album,Unreleased Tapes 1981-1984,Mamman Sani,USD,7.0,1.0,,7.0,,,,,,7.0,0.0,570320528,,0.7,0.0,3.8,0.0,304.0,6.3,digital download,,http://mammansani.bandcamp.com/album/unreleased-tapes-1981-1984,,SS-030,889326 667568,,Alexis Carey,harroyo@yahoo.com,001-269-023-6784x65398,,Nicholas Robinson,2915 Pruitt Green Apt. 199,,,,,,,,,United States,US,CA,San Diego,,
96,1/9/20 4:40am,Bandcamp,album,La Musique Electronique du Niger,Mamman Sani,USD,7.0,1.0,,7.0,,,,,,7.0,0.0,570320528,,0.7,0.0,4.5,0.0,304.0,6.3,digital download,,http://mammansani.bandcamp.com/album/la-musique-electronique-du-niger,,SS-011,889326 664864,,Alexis Carey,robert02@gmail.com,572-286-2209x4925,,Karen Johnson,03510 Lee Mountain Suite 374,,,,,,,,,United States,US,CA,San Diego,,
97,1/9/20 4:40am,Bandcamp,album,Taaritt,Mamman Sani,USD,7.0,1.0,,7.0,,,,,,7.0,0.0,570320528,,0.7,5.2,0.0,45.51,349.51,6.3,digital download,,http://mammansani.bandcamp.com/album/taaritt,,SS-023,889326 664871,,Alexis Carey,nwilliams@gmail.com,+1-126-180-4855x28932,,Cynthia Nguyen,9771 Colleen Shoals Apt. 309,,,,,,,,,United States,US,CA,San Diego,,
98,1/9/20 6:45am,Bandcamp,package,Ilana: The Creator,Mdou Moctar,USD,17.0,1.0,,17.0,,5.0,United States,0.78,credit card,22.0,0.0,825417674,,1.7,1.7,0.0,19.52,369.03,14.52,Ilana LP,,http://mdoumoctar.bandcamp.com/album/ilana-the-creator,SS-051lp,SS-051,602318 136893,,Sean Miller,johnsonjoseph@gmail.com,(898)692-0835x554,,Anne Riley,6786 Tiffany Locks,,Decatur,GA,30032,United States,US,1/14/20,,United States,US,GA,Decatur,Bandcamp artist: kikagakumoyoggb,kikagakumoyoggb.bandcamp.com
99,1/9/20 7:55am,Bandcamp,package,Ilana: The Creator,Mdou Moctar,USD,12.0,1.0,,12.0,,10.0,United States,0.94,paypal,22.0,0.0,1439953012,,1.2,1.2,0.0,19.86,388.89,9.86,Ilana: The Creator CD,,http://mdoumoctar.bandcamp.com/album/ilana-the-creator,SS-051cd,SS-051,602318 136893,,Tamara Crosby,garciasarah@hotmail.com,001-971-394-7943,,Ryan Lynch,1592 Garcia Glens Apt. 492,,STRASBOURG,,67100,France,FR,1/14/20,,France,FR,,STRASBOURG,Google search,www.google.com/
100,1/9/20 8:22am,Bandcamp,album,Ilana: The Creator,Mdou Moctar,USD,7.0,1.0,,7.0,1.68,,,0.58,credit card,8.68,0.0,3178203106,,0.7,0.7,0.0,5.72,394.61,5.72,digital download,,http://mdoumoctar.bandcamp.com/album/ilana-the-creator,,SS-051,602318 136893,,Julie Hernandez,jwilliamson@gmail.com,3138932207,,Vincent Kramer,35718 Bailey Mission Apt. 603,,,,,,,,,Finland,FI,Uusimaa,Helsinki,Bandcamp search: “mdou moctar”,bandcamp.com/search?q=Mdou%20Moctar
101,1/9/20 9:50am,Bandcamp,package,La Musique Electronique du Niger,Mamman Sani,USD,17.0,1.0,,17.0,,24.0,United States,2.38,credit card,41.0,0.0,3059667953,,1.7,0.0,1.7,0.0,394.61,12.92,Mamman Sani remastered LP,,http://mammansani.bandcamp.com/album/la-musique-electronique-du-niger,SS-011lp-1,SS-011,889326 664864,,Larry Nguyen,nicole60@schwartz.org,+1-079-176-0190x4970,,Amanda Wood,061 Shawna Center,,Noisy le sec,,93130,France,FR,1/14/20,,France,FR,,Noisy le sec,Bandcamp artist: mammansani,mammansani.bandcamp.com/album/taaritt
102,1/9/20 9:50am,Bandcamp,package,Taaritt,Mamman Sani,USD,17.0,1.0,,17.0,,7.0,United States,,,24.0,0.0,3059667953,,1.7,3.4,0.0,59.22,453.83,15.3,Taaritt LP,,http://mammansani.bandcamp.com/album/taaritt,SS-023lp,SS-023,889326 664871,,Larry Nguyen,kellyromero@hall.net,001-593-772-7994,,Jeffrey Marshall,866 Hall Brooks Apt. 174,,Noisy le sec,,93130,France,FR,1/14/20,,France,FR,,Noisy le sec,,
103,1/9/20 11:52am,Bandcamp,package,Akounak Tedalat Taha Tazoughai OST,Mdou Moctar,USD,17.0,1.0,,17.0,,24.0,United States,2.28,credit card,41.0,0.0,3493612968,,1.7,0.0,1.7,0.0,453.83,13.02,Akounak OST LP,,http://mdoumoctar.bandcamp.com/album/akounak-tedalat-taha-tazoughai-ost,SS-028lp-1,SS-028,889326 667599,,Ricky Dominguez,pooleandre@rocha.com,253-601-6739,,Daniel Mclaughlin,72252 Willis Forest Suite 141,,Flawil,St.Gallen,9230,Switzerland,CH,1/14/20,,Switzerland,CH,St.Gallen,Flawil,Bandcamp fan page: backspace,bandcamp.com/backspace
104,1/9/20 11:52am,Bandcamp,package,Ilana: The Creator,Mdou Moctar,USD,17.0,1.0,,17.0,,4.0,United States,,,21.0,0.0,3493612968,,1.7,3.4,0.0,56.32,510.15,15.3,Ilana LP,,http://mdoumoctar.bandcamp.com/album/ilana-the-creator,SS-051lp,SS-051,602318 136893,,Ricky Dominguez,danielcox@day.com,(465)476-5220x7066,,Laura Kaufman,2489 Adams Port,,Flawil,St.Gallen,9230,Switzerland,CH,1/14/20,,Switzerland,CH,St.Gallen,Flawil,Bandcamp fan page: backspace,bandcamp.com/backspace
105,1/9/20 12:06pm,Bandcamp,album,Terrouzi,Ahmedou Ahmed Lowla,USD,7.0,1.0,,7.0,1.47,,,0.57,credit card,8.47,0.0,3075661701,,0.7,0.7,0.0,5.73,515.88,5.73,digital download,,http://ahmedouahmedlowla.bandcamp.com/album/terrouzi,,SS-054,602318 137029,,Nicholas Velasquez,kathryn45@gmail.com,8543231202,,Michele Daniel,961 Flores Turnpike,,,,,,,,,Indonesia,ID,West Java,Bandung,planetrock-booking.de,www.planetrock-booking.de/44-0-Ahmedou-Ahmed-Lowla.html
106,1/9/20 2:52pm,Bandcamp,album,Eghass Malan,Les Filles de Illighadad,USD,7.0,1.0,,7.0,1.47,,,0.57,credit card,8.47,0.0,616892088,,0.7,0.7,0.0,5.73,521.61,5.73,digital download,,http://lesfillesdeillighadad.bandcamp.com/album/eghass-malan,,SS-044,191515 928351,,Kristen Watkins,joseph67@hotmail.com,(094)094-7118x537,,Lacey Morgan,00769 Tanya Shore,,,,,,,,,Portugal,PT,Lisbon,Lisbon,,
107,1/9/20 3:31pm,Bandcamp,album,Ilana: The Creator,Mdou Moctar,USD,7.0,1.0,,7.0,1.4,,,0.54,gift card,8.4,0.0,3634185314,,0.7,0.7,0.0,5.76,527.37,5.76,digital download,,http://mdoumoctar.bandcamp.com/album/ilana-the-creator,,SS-051,602318 136893,,Carmen Ellis,robert69@yahoo.com,+1-022-924-0973x143,,Gloria Mccann,24604 Huber Cliff,,,,,,,,,United Kingdom,GB,England,London,Bandcamp home page,bandcamp.com/
108,1/9/20 6:03pm,shop@sahelsounds.com,payout,,,USD,,,,,,,,1.46,transfer,145.59,144.13,t249919509,3HA92000K69609412,,,,-145.59,381.78,,,,,,,,,,,,,,,,,,,,,,,,,,,,
109,1/9/20 6:03pm,shop@sahelsounds.com,payout,,,USD,,,,,,,,0.54,transfer,53.76,53.22,t249919504,3C535981WR947813A,,,,-53.76,328.02,,,,,,,,,,,,,,,,,,,,,,,,,,,,
110,1/9/20 7:00pm,Bandcamp,package,Eghass Malan,Les Filles de Illighadad,USD,17.0,1.0,,17.0,,5.0,United States,0.72,paypal,22.0,0.0,4113180121,,1.7,1.7,0.0,19.58,347.6,14.58,'Eghass Malan' LP,,http://lesfillesdeillighadad.bandcamp.com/album/eghass-malan,SS-044lp-1,SS-044,191515 928351,,Sarah Malone,marquezdavid@peterson.biz,001-338-977-9175x564,,Bradley Wallace,4763 Jamie Lakes Apt. 176,,Ann Arbor,MI,48103,United States,US,1/14/20,,United States,US,MI,Ann Arbor,Google search,www.google.com/
111,1/9/20 9:27pm,Bandcamp,package,Ilana: The Creator,Mdou Moctar,USD,30.0,1.0,,30.0,,5.0,United States,0.97,paypal,35.0,0.0,500488063,,3.0,3.0,0.0,31.03,378.63,26.03,Ilana: The Creator shirt,Large,http://mdoumoctar.bandcamp.com/merch/ilana-the-creator-shirt,SS-MDOU-BIRD-SHIRT-L,,,,Madison Taylor,justinrose@ford.biz,(976)537-3123,,Corey Logan,6793 Chung Ridges,,Harrisonburg,VA,22802,United States,US,1/14/20,,United States,US,VA,Harrisonburg,,
112,1/9/20 9:48pm,Bandcamp,album,Music from Saharan Cellphones,Various,USD,7.0,1.0,,7.0,,,,0.4,credit card,7.0,0.0,1257718118,,0.7,0.7,0.0,5.9,384.53,5.9,digital download,,http://sahelsounds.bandcamp.com/album/music-from-saharan-cellphones,,SS-003,889326 667889,,Megan Fischer,sandra51@gmail.com,(327)375-8628x6422,,Sarah Williams,098 Weiss Squares Apt. 875,,,,,,,,,United States,US,OH,,Bandcamp artist: sahelsounds,sahelsounds.bandcamp.com/track/tahoultine
113,1/10/20 1:21am,Bandcamp,album,Ilana: The Creator,Mdou Moctar,USD,7.0,1.0,,7.0,,,,0.57,paypal,7.0,0.0,1033257791,,0.7,0.0,0.7,0.0,384.53,5.73,digital download,,http://mdoumoctar.bandcamp.com/album/ilana-the-creator,,SS-051,602318 136893,,Cassandra Taylor,bishopmelissa@roberson.org,001-839-499-9055x658,,Lisa Phillips,14707 Butler Brook,,,,,,,,,United States,US,NY,Brooklyn,Bandcamp Daily: sahel-sounds-label-interview,daily.bandcamp.com/label-profile/sahel-sounds-label-interview
114,1/10/20 1:21am,Bandcamp,album,Les Filles de Illighadad,Les Filles de Illighadad,USD,7.0,1.0,,7.0,,,,,,7.0,0.0,1033257791,,0.7,1.4,0.0,12.03,396.56,6.3,digital download,,http://lesfillesdeillighadad.bandcamp.com/album/les-filles-de-illighadad,,SS-033,889326 664918,,Cassandra Taylor,fbowman@hotmail.com,5816899092,,Veronica Norman,66509 Pamela Lights,,,,,,,,,United States,US,NY,Brooklyn,Recommendations footer: commonly collected,bandcamp.com/footer/cc/a257703293
115,1/10/20 6:37am,Bandcamp,album,Eghass Malan,Les Filles de Illighadad,USD,10.0,1.0,,10.0,,,,0.49,paypal,10.0,0.0,2946299361,,1.0,1.0,0.0,8.51,405.07,8.51,digital download,,http://lesfillesdeillighadad.bandcamp.com/album/eghass-malan,,SS-044,191515 928351,,Joshua Thompson,astevens@yahoo.com,(796)374-7621,,Paul Ho,762 Nathan Gardens Suite 784,,,,,,,,,United States,US,MD,Baltimore,,
116,1/10/20 11:41am,Bandcamp,album,Music from Saharan Cellphones,Various,USD,7.0,1.0,,7.0,1.4,,,0.54,paypal,8.4,0.0,1406369152,,0.7,0.7,0.0,5.76,410.83,5.76,digital download,,http://sahelsounds.bandcamp.com/album/music-from-saharan-cellphones,,SS-003,889326 667889,,Erika Leonard,aberry@gmail.com,502-444-4216x500,,Alexander Jordan,6603 Steven Heights,,,,,,,,,United Kingdom,GB,West Sussex,Worthing,Bandcamp search,bandcamp.com/app/android/search
117,1/10/20 1:13pm,Bandcamp,package,Sahel Sounds Label Sampler,Various Artists,USD,20.0,1.0,,20.0,,15.0,United States,1.32,paypal,35.0,0.0,1983025656,,2.0,2.0,0.0,31.68,442.51,16.68,Sahel Sounds t-shirt,XL,http://sahelsounds.bandcamp.com/merch/sahel-sounds-t-shirt,SS-T01-BLK-UXL,,,,Patrick King,martinezjulie@yahoo.com,001-221-117-7902x28792,Love what you guys do!,Matthew Anderson,9911 Ramos Corners,,London,,E5 0JS,United Kingdom,GB,1/14/20,,United Kingdom,GB,,London,Bandcamp search: “sahel sounds”,bandcamp.com/search?q=sahel%20sounds
118,1/10/20 3:18pm,Bandcamp,album,Ilana: The Creator,Mdou Moctar,USD,7.0,1.0,,7.0,1.33,,,0.54,paypal,8.33,0.0,2712873105,,0.7,0.7,0.0,5.76,448.27,5.76,digital download,,http://mdoumoctar.bandcamp.com/album/ilana-the-creator,,SS-051,602318 136893,,Tommy Nolan,ikane@hotmail.com,667.565.4494x7898,,Andrea Sandoval,075 Ethan Groves,,,,,,,,,Germany,DE,Land Berlin,Berlin,Google search,www.google.com/
119,1/10/20 4:27pm,Bandcamp,package,Ilana: The Creator,Mdou Moctar,USD,50.0,1.0,,50.0,,6.0,United States,1.36,paypal,56.0,0.0,750750297,,5.0,5.0,0.0,49.64,497.91,43.64,Ilana The Creator shirt & LP bundle,MEDIUM,http://mdoumoctar.bandcamp.com/merch/ilana-the-creator-shirt-lp-bundle,SS-051lp*-T02-W-UMD,,,,Justin Torres,jordan50@gmail.com,001-246-142-0005x209,,Chelsea Horton,0466 Fletcher Isle Apt. 992,3,Salt Lake City,UT,84103,United States,US,1/14/20,,United States,US,UT,Salt Lake City,Bandcamp search,bandcamp.com/app/android/search
120,1/10/20 5:12pm,Bandcamp,album,Tenere,Afous d'Afous,USD,7.0,1.0,,7.0,1.33,,,0.54,paypal,8.33,0.0,2932462159,,0.7,0.7,0.0,5.76,503.67,5.76,digital download,,http://afousdafous.bandcamp.com/album/tenere,,SS-042,191515 490421,,Sonia Mason,youngsteven@gmail.com,(022)403-3512,,Joseph Ward,180 Hoffman Cliffs,,,,,,,,,Germany,DE,Bavaria,Starnberg,Google search,www.google.com/
121,1/10/20 5:16pm,Bandcamp,album,Takamba WhatsApp 2018 EP,Tallawit Timbouctou,USD,1.0,1.0,,1.0,,,,0.11,paypal,1.0,0.0,2432320594,,0.1,0.1,0.0,0.79,504.46,0.79,digital download,,http://tallawit.bandcamp.com/album/takamba-whatsapp-2018-ep,,SS-056,602318 137098,,Ryan Perry,michaellyons@kelly.biz,(637)087-6379x70470,,Cynthia Shannon,472 Chang Valley Suite 304,,,,,,,,,Russia,RU,Moscow,Moscow,Google search,www.google.com/
122,1/10/20 5:16pm,Bandcamp,album,Music from Saharan Cellphones,Various,USD,25.0,1.0,,25.0,1.4,,,1.14,credit card,26.4,0.0,2470018711,,2.5,2.5,0.0,21.36,525.82,21.36,digital download,,http://sahelsounds.bandcamp.com/album/music-from-saharan-cellphones,,SS-003,889326 667889,,Brad Miller,vanessa37@yahoo.com,5738397454,,Lisa Johnson,56046 Davies Via Apt. 451,,,,,,,,,United Kingdom,GB,Kingston upon Hull,Hull,,
123,1/10/20 5:21pm,Bandcamp,album,Zerzura (Original Soundtrack Recording),Ahmoudou Madassane,USD,7.0,1.0,,7.0,,,,0.4,credit card,7.0,0.0,1191711528,,0.7,0.7,0.0,5.9,531.72,5.9,digital download,,http://ahmoudoumadassane.bandcamp.com/album/zerzura-original-soundtrack-recording,,SS-046,656605 382067,,Stephanie Hardy,qmora@myers.net,1448448840,,Colleen Reed,62094 Crystal Cliffs Apt. 442,,,,,,,,,United States,US,OR,Portland,,
124,1/10/20 6:03pm,shop@sahelsounds.com,payout,,,USD,,,,,,,,3.21,transfer,320.55,317.34,t250217536,0B1242824B3697258,,,,-320.55,211.17,,,,,,,,,,,,,,,,,,,,,,,,,,,,
125,1/10/20 6:03pm,shop@sahelsounds.com,payout,,,USD,,,,,,,,0.07,transfer,7.47,7.4,t250217535,1BT07055S9333630T,,,,-7.47,203.7,,,,,,,,,,,,,,,,,,,,,,,,,,,,
126,1/10/20 6:11pm,Bandcamp,album,Music from Saharan Cellphones,Various,USD,7.0,1.0,,7.0,,,,0.51,paypal,7.0,0.0,1324351799,,0.7,0.0,0.7,0.0,203.7,5.79,digital download,,http://sahelsounds.bandcamp.com/album/music-from-saharan-cellphones,,SS-003,889326 667889,,Alexis Mcdaniel,ccollins@simpson.com,4818946284,,Lawrence James,82359 Knapp Land Suite 298,,,,,,,,,United States,US,DC,Washington,t.umblr.com,t.umblr.com/
127,1/10/20 6:11pm,Bandcamp,album,Field Recordings from the Sahel,Sahel Sounds,USD,4.0,1.0,,4.0,,,,,,4.0,0.0,1324351799,,0.4,1.1,0.0,9.39,213.09,3.6,digital download,,http://sahelsounds.bandcamp.com/album/field-recordings-from-the-sahel,,SS-057,602318 137104,,Alexis Mcdaniel,gibsoncourtney@gmail.com,001-844-612-7220x42907,,Amy Swanson,561 Nguyen Islands Suite 308,,,,,,,,,United States,US,DC,Washington,,
128,1/10/20 6:29pm,Bandcamp,package,Ilana: The Creator,Mdou Moctar,USD,30.0,1.0,,30.0,,5.0,United States,1.07,credit card,35.0,0.0,3949878252,,3.0,3.0,0.0,30.93,244.02,25.93,Ilana: The Creator shirt,Medium,http://mdoumoctar.bandcamp.com/merch/ilana-the-creator-shirt,SS-MDOU-BIRD-SHIRT-M,,,,Maria Welch,cynthia82@andrade-hayes.com,8465317266,,Emma Velazquez,383 Anthony Ridges Apt. 482,,Clemson,SC,29632,United States,US,1/14/20,,United States,US,SC,Clemson,Bandcamp artist: psychedelicporncrumpets,psychedelicporncrumpets.bandcamp.com
129,1/10/20 6:40pm,Bandcamp,album,Akounak Tedalat Taha Tazoughai OST,Mdou Moctar,USD,7.0,1.0,,7.0,,,,0.47,credit card,7.0,0.0,3871390480,,0.7,0.7,0.0,5.83,249.85,5.83,digital download,,http://mdoumoctar.bandcamp.com/album/akounak-tedalat-taha-tazoughai-ost,,SS-028,889326 667599,,Randall Taylor,sharris@gmail.com,060-743-7090x555,,Mary Smith,54949 Jeffery Track,,,,,,,,,Canada,CA,ON,Milton,Google search,www.google.com/
130,1/10/20 10:00pm,Bandcamp,album,Ilana: The Creator,Mdou Moctar,USD,10.0,1.0,,10.0,1.33,,,0.63,paypal,11.33,0.0,168885831,,1.0,1.0,0.0,8.37,258.22,8.37,digital download,,http://mdoumoctar.bandcamp.com/album/ilana-the-creator,,SS-051,602318 136893,,Taylor Shah,wdavidson@saunders-johnson.biz,+1-433-711-8073x58052,,Lindsay Flores,868 Victoria Field,,,,,,,,,Germany,DE,Bavaria,Nuremberg,Google search,www.google.de/
131,1/10/20 11:05pm,Bandcamp,album,Music from Saharan Cellphones,Various,USD,8.0,1.0,,8.0,,,,0.45,paypal,8.0,0.0,3550571906,,0.8,0.8,0.0,6.75,264.97,6.75,digital download,,http://sahelsounds.bandcamp.com/album/music-from-saharan-cellphones,,SS-003,889326 667889,,Michelle Patterson,pevans@hotmail.com,001-082-384-1505x87369,,Austin Salazar,3624 Alvarez Drive Suite 892,,,,,,,,,United States,US,TX,College Station,,
132,1/11/20 12:50am,Bandcamp,package,Ilana: The Creator,Mdou Moctar,USD,15.0,1.0,,15.0,,3.0,United States,0.64,paypal,18.0,0.0,1349868885,,1.5,1.5,0.0,15.86,280.83,12.86,Ilana: The Creator CD,,http://mdoumoctar.bandcamp.com/album/ilana-the-creator,SS-051cd,SS-051,602318 136893,,Tommy Gonzalez,leslie85@foster.com,(855)758-7872,"Your playing is phenomenal, and something the music world desperately needs right now! I’ll be looking forward to your music and keeping my ears open!",Joseph Hart,8734 Salas Garden Suite 285,,Santa Clara,CA,95051,United States,US,1/14/20,,United States,US,CA,Santa Clara,Google search,www.google.com/
133,1/11/20 1:02am,Bandcamp,album,Eghass Malan,Les Filles de Illighadad,USD,10.0,1.0,,10.0,,,,0.52,credit card,10.0,0.0,4031341413,,1.0,1.0,0.0,8.48,289.31,8.48,digital download,,http://lesfillesdeillighadad.bandcamp.com/album/eghass-malan,,SS-044,191515 928351,,Isabella Mitchell,steven70@adams-mason.net,079.338.6663,,William Zhang,3626 Allen Views,,,,,,,,,United States,US,CA,Concord,,
134,1/11/20 3:49am,Bandcamp,album,Houmeissa,Hama,USD,7.0,1.0,,7.0,,,,0.47,paypal,7.0,0.0,958722104,,0.7,0.7,0.0,5.83,295.14,5.83,digital download,,http://hamasynth.bandcamp.com/album/houmeissa,,SS-049,656605 382364,,Stephanie Ramirez,christinaolson@wallace-ochoa.com,671.548.2310,,Wendy Dudley,55514 Elizabeth Ridge Suite 755,,,,,,,,,Australia,AU,NSW,Sydney,Bandcamp Daily: the-best-albums-of-2019-80-61,daily.bandcamp.com/best-of-2019/the-best-albums-of-2019-80-61
135,1/11/20 5:07am,Bandcamp,album,Sahel Sounds Label Sampler,Various Artists,USD,1.0,1.0,,1.0,,,,0.1,paypal,1.0,0.0,1134266987,,0.1,0.1,0.0,0.8,295.94,0.8,digital download,,http://sahelsounds.bandcamp.com/album/sahel-sounds-label-sampler,,SS-058,602318 137111,,Thomas Wilson,munozlisa@anderson.com,6653864506,,Becky Peterson,67413 Dustin Common,,,,,,,,,United States,US,PA,Philadelphia,sahelsounds.com,sahelsounds.com/
136,1/11/20 8:11am,Bandcamp,album,Ilana: The Creator,Mdou Moctar,USD,7.0,1.0,,7.0,,,,0.76,paypal,7.0,0.0,3193277079,,0.7,0.0,0.7,0.0,295.94,5.54,digital download,,http://mdoumoctar.bandcamp.com/album/ilana-the-creator,,SS-051,602318 136893,,Michael Stark,williamssandra@cole.net,(401)117-1447x710,,Edward Harvey,414 Andrew Locks Apt. 893,,,,,,,,,United States,US,CA,Oakland,,
137,1/11/20 8:11am,Bandcamp,album,Afelan,Mdou Moctar,USD,7.0,1.0,,7.0,,,,,,7.0,0.0,3193277079,,0.7,0.0,1.4,0.0,295.94,6.3,digital download,,http://mdoumoctar.bandcamp.com/album/afelan,,SS-017,889326 664840,,Michael Stark,michellefigueroa@gmail.com,(905)746-6700x4315,,Douglas Smith,696 Jessica Ville,,,,,,,,,United States,US,CA,Oakland,,
138,1/11/20 8:11am,Bandcamp,album,Sahel Sounds Label Sampler,Various Artists,USD,10.0,1.0,,10.0,,,,,,10.0,0.0,3193277079,,1.0,2.4,0.0,20.84,316.78,9.0,digital download,,http://sahelsounds.bandcamp.com/album/sahel-sounds-label-sampler,,SS-058,602318 137111,,Michael Stark,wgillespie@hotmail.com,+1-096-555-1613,,Shawn Choi,8930 Elaine Field,,,,,,,,,United States,US,CA,Oakland,,
139,1/11/20 8:44am,Bandcamp,album,Les Filles de Illighadad,Les Filles de Illighadad,USD,7.0,1.0,,7.0,,,,0.4,paypal,7.0,0.0,832856973,,0.7,0.7,0.0,5.9,322.68,5.9,digital download,,http://lesfillesdeillighadad.bandcamp.com/album/les-filles-de-illighadad,,SS-033,889326 664918,,Michael Stark,pcrawford@anderson.net,001-664-674-6726x4851,,Laura Vang,760 Richard Avenue Suite 121,,,,,,,,,United States,US,CA,Oakland,,
140,1/11/20 11:35am,Bandcamp,album,Ilana: The Creator,Mdou Moctar,USD,10.0,1.0,,10.0,1.4,,,0.63,paypal,11.4,0.0,8396143,,1.0,1.0,0.0,8.37,331.05,8.37,digital download,,http://mdoumoctar.bandcamp.com/album/ilana-the-creator,,SS-051,602318 136893,,Brandy Roberts,dorothy12@gmail.com,001-282-300-5515x97115,,Melanie Holt,7168 Richards Hill,,,,,,,,,United Kingdom,GB,Lancashire,Preston,,
141,1/11/20 11:50am,Bandcamp,album,Ilana: The Creator,Mdou Moctar,USD,8.0,1.0,,8.0,,,,0.45,credit card,8.0,0.0,397879041,,0.8,0.8,0.0,6.75,337.8,6.75,digital download,,http://mdoumoctar.bandcamp.com/album/ilana-the-creator,,SS-051,602318 136893,,John Johnson,nwilliams@reed-conner.com,+1-116-004-8744x302,,James Davis,877 Robert Pine,,,,,,,,,United States,US,NY,Lockport,,
142,1/11/20 1:51pm,Bandcamp,album,Music from Saharan Cellphones: Volume 2,Various,USD,7.0,1.0,,7.0,,,,0.4,paypal,7.0,0.0,1697191782,,0.7,0.7,0.0,5.9,343.7,5.9,digital download,,http://sahelsounds.bandcamp.com/album/music-from-saharan-cellphones-volume-2,,SS-012,889326 667742,,Cameron Jackson,gloriabarnett@gmail.com,7238924168,,Joshua Murphy,08472 Harris Viaduct Apt. 628,,,,,,,,,United States,US,NJ,Pine Brook,shop.sahelsounds.com,shop.sahelsounds.com/collections/musics
143,1/11/20 1:52pm,Bandcamp,album,Music from Saharan Cellphones,Various,USD,7.0,1.0,,7.0,,,,0.4,paypal,7.0,0.0,179160660,,0.7,0.7,0.0,5.9,349.6,5.9,digital download,,http://sahelsounds.bandcamp.com/album/music-from-saharan-cellphones,,SS-003,889326 667889,,Cameron Jackson,qsmith@gmail.com,+1-320-772-0370x365,,Nicholas Underwood,044 Hall Island Suite 521,,,,,,,,,United States,US,NJ,Pine Brook,,
144,1/11/20 2:01pm,Bandcamp,package,Ilana: The Creator,Mdou Moctar,USD,15.0,1.0,,15.0,,10.0,United States,1.03,paypal,25.0,0.0,3864374991,,1.5,1.5,0.0,22.47,372.07,12.47,Ilana: The Creator CD,,http://mdoumoctar.bandcamp.com/album/ilana-the-creator,SS-051cd,SS-051,602318 136893,,Cody Wall,daniel81@hotmail.com,001-834-570-9926x848,,Timothy Brown,0568 Katherine Pike Suite 993,,kaatsheuvel,brabant,5171wx,Netherlands,NL,1/14/20,,Netherlands,NL,brabant,kaatsheuvel,,
145,1/11/20 3:37pm,Bandcamp,album,Ilana: The Creator,Mdou Moctar,USD,7.0,1.0,,7.0,,,,0.47,credit card,7.0,0.0,3893215313,,0.7,0.7,0.0,5.83,377.9,5.83,digital download,,http://mdoumoctar.bandcamp.com/album/ilana-the-creator,,SS-051,602318 136893,,David Roberts,vsanchez@hotmail.com,(374)210-2238,,Matthew Garcia,292 Christine Mall Suite 972,,,,,,,,,Canada,CA,ON,Toronto,Google search,www.google.com/
146,1/11/20 4:23pm,Bandcamp,album,Balani Show Super Hits: Electronic Street Parties from Mali,Various,USD,7.0,1.0,,7.0,1.4,,,0.57,credit card,8.4,0.0,2910404537,,0.7,0.7,0.0,5.73,383.63,5.73,digital download,,http://sahelsounds.bandcamp.com/album/balani-show-super-hits-electronic-street-parties-from-mali,,SS-021,889326 667643,,James Reyes,wilsonbailey@hughes.com,(739)171-6081,,Gary Singleton,29051 Gonzalez Glens Apt. 813,,,,,,,,,France,FR,Upper Garonne,Toulouse,Google search,www.google.com/
147,1/11/20 5:18pm,Bandcamp,album,Ilana: The Creator,Mdou Moctar,USD,7.0,1.0,,7.0,1.33,,,0.54,paypal,8.33,0.0,2630668617,,0.7,0.7,0.0,5.76,389.39,5.76,digital download,,http://mdoumoctar.bandcamp.com/album/ilana-the-creator,,SS-051,602318 136893,,Nicholas Daniels,matthewking@yahoo.com,025-628-1845,,Paul Clark,175 Martinez Walk Suite 699,,,,,,,,,Germany,DE,Hesse,Frankfurt am Main,Google search,www.google.com/
148,1/11/20 6:02pm,shop@sahelsounds.com,payout,,,USD,,,,,,,,0.13,transfer,12.59,12.46,t250501929,5519173628723501Y,,,,-12.59,376.8,,,,,,,,,,,,,,,,,,,,,,,,,,,,
149,1/11/20 6:03pm,shop@sahelsounds.com,payout,,,USD,,,,,,,,1.91,transfer,191.11,189.2,t250501930,3T278532TR980762C,,,,-191.11,185.69,,,,,,,,,,,,,,,,,,,,,,,,,,,,
150,1/11/20 6:05pm,Bandcamp,album,Music from Saharan Cellphones,Various,USD,10.0,1.0,,10.0,,,,0.49,paypal,10.0,0.0,2073742225,,1.0,1.0,0.0,8.51,194.2,8.51,digital download,,http://sahelsounds.bandcamp.com/album/music-from-saharan-cellphones,,SS-003,889326 667889,,Nicole Smith,kayla85@gmail.com,+1-210-699-8178x76126,,Michael Wilson,7458 Christine Trafficway,,,,,,,,,United States,US,TX,San Antonio,,
151,1/11/20 9:15pm,Bandcamp,album,Waande Kadde,Amadou Binta Konté and Tidiane Thiam,USD,10.0,1.0,,10.0,,,,0.52,credit card,10.0,0.0,1213111523,,1.0,1.0,0.0,8.48,202.68,8.48,digital download,,http://sahelsounds.bandcamp.com/album/waande-kadde,,SS-036 / SFH-01,889326 796008,,Robert Chandler,yhoward@hartman-carpenter.com,487-369-3385x99542,,John Figueroa,68386 Amy Drive,,,,,,,,,United States,US,OR,Portland,,
152,1/11/20 10:18pm,Bandcamp,package,Eghass Malan,Les Filles de Illighadad,USD,13.0,1.0,,13.0,,14.0,United States,1.16,credit card,27.0,0.0,813561096,,1.3,1.3,0.0,24.54,227.22,10.54,'Eghass Malan' compact disc,,http://lesfillesdeillighadad.bandcamp.com/album/eghass-malan,SS-044cd-1,SS-044,191515 928351,,Calvin Pope,curryvictoria@brown.com,263-394-4479,,Theodore Jones,54480 Mills Isle Apt. 839,,Dublin 18,Leinster,D18AR20,Ireland,IE,1/14/20,,Ireland,IE,Leinster,Dublin 18,,
153,1/11/20 11:20pm,Bandcamp,package,Hali Diallo,Tallawit Timbouctou,USD,17.0,1.0,,17.0,,2.0,United States,2.16,paypal,19.0,0.0,1894423560,,1.7,0.0,1.7,0.0,227.22,13.14,Vinyl LP,,http://tallawit.bandcamp.com/album/hali-diallo,SS-048lp,SS-048,656605 382265,,Larry Wilkins,unolan@stafford.com,(535)377-9445,,Laura Brown,55653 Tracy Brooks,,Warrenton,VA,20186,United States,US,1/14/20,,United States,US,VA,Warrenton,,
154,1/11/20 11:20pm,Bandcamp,package,Akounak Tedalat Taha Tazoughai OST,Mdou Moctar,USD,17.0,1.0,,17.0,,2.0,United States,,,19.0,0.0,1894423560,,1.7,0.0,3.4,0.0,227.22,15.3,Akounak OST LP,,http://mdoumoctar.bandcamp.com/album/akounak-tedalat-taha-tazoughai-ost,SS-028lp-1,SS-028,889326 667599,,Larry Wilkins,colemankayla@hotmail.com,+1-721-185-6242x32564,,Jessica Brown,8329 Parker Ramp,,Warrenton,VA,20186,United States,US,1/14/20,,United States,US,VA,Warrenton,,
155,1/11/20 11:20pm,Bandcamp,package,Afelan,Mdou Moctar,USD,17.0,1.0,,17.0,,2.0,United States,,,19.0,0.0,1894423560,,1.7,0.0,5.1,0.0,227.22,15.3,Afelan LP,,http://mdoumoctar.bandcamp.com/album/afelan,SS-017lp,SS-017,889326 664840,,Larry Wilkins,heathertaylor@jones-scott.org,(375)318-2084,,Joseph Murphy,450 Donald Estate,,Warrenton,VA,20186,United States,US,1/14/20,,United States,US,VA,Warrenton,,
156,1/11/20 11:20pm,Bandcamp,package,Anou Malane,Abdallah Ag Oumbadougou,USD,17.0,1.0,,17.0,,5.0,United States,,,22.0,0.0,1894423560,,1.7,0.0,6.8,0.0,227.22,15.3,Vinyl,,http://abdallahagoumbadougou.bandcamp.com/album/anou-malane,SS-053lp,SS-053,602318 136992,,Larry Wilkins,billywise@james-russell.com,(122)709-1336,,Michelle Miller,142 Dakota Knoll Suite 229,,Warrenton,VA,20186,United States,US,1/14/20,,United States,US,VA,Warrenton,,
157,1/11/20 11:20pm,Bandcamp,package,Falaw,Luka Productions,USD,17.0,1.0,,17.0,,2.0,United States,,,19.0,0.0,1894423560,,1.7,8.5,0.0,87.34,314.56,15.3,Limited Edition Vinyl,,http://lukaproductions.bandcamp.com/album/falaw,SS-052lp,SS-052,602318 136855,,Larry Wilkins,gordonalexis@jenkins-choi.org,001-096-049-8957x271,,Christopher Davis,23613 Brian Bypass Apt. 196,,Warrenton,VA,20186,United States,US,1/14/20,,United States,US,VA,Warrenton,,
158,1/12/20 2:02am,Bandcamp,album,Ilana: The Creator,Mdou Moctar,USD,7.0,1.0,,7.0,,,,0.4,paypal,7.0,0.0,4117512783,,0.7,0.7,0.0,5.9,320.46,5.9,digital download,,http://mdoumoctar.bandcamp.com/album/ilana-the-creator,,SS-051,602318 136893,,Molly Waters,wilcoxdavid@gonzalez.com,514.295.6797x18460,,Michael Chavez,40848 Carter Land,,,,,,,,,United States,US,NJ,Secaucus,,
159,1/12/20 3:37am,Bandcamp,package,Ilana: The Creator,Mdou Moctar,USD,12.0,1.0,,12.0,,2.0,United States,0.98,paypal,14.0,0.0,1051907331,,1.2,0.0,1.2,0.0,320.46,9.82,Ilana: The Creator CD,,http://mdoumoctar.bandcamp.com/album/ilana-the-creator,SS-051cd,SS-051,602318 136893,,Michael Barrett,johnwells@yahoo.com,981.461.7840,,Christine Richards,9991 Parrish Circle,,Victoria,TX,77904,United States,US,1/14/20,,United States,US,TX,Victoria,Bandcamp home page,bandcamp.com/
160,1/12/20 3:37am,Bandcamp,package,Ilana: The Creator,Mdou Moctar,USD,17.0,1.0,,17.0,,5.0,United States,,,22.0,0.0,1051907331,,1.7,2.9,0.0,32.12,352.58,15.3,Ilana LP,,http://mdoumoctar.bandcamp.com/album/ilana-the-creator,SS-051lp,SS-051,602318 136893,,Michael Barrett,jenniferfitzpatrick@murphy.info,+1-679-452-2557,,Kevin Mercer,99505 Delacruz Plaza,,Victoria,TX,77904,United States,US,1/14/20,,United States,US,TX,Victoria,Bandcamp home page,bandcamp.com/
161,1/12/20 3:38am,Bandcamp,package,Ilana: The Creator,Mdou Moctar,USD,17.0,1.0,,17.0,,5.0,United States,0.72,paypal,22.0,0.0,414524060,,1.7,1.7,0.0,19.58,372.16,14.58,Ilana LP,,http://mdoumoctar.bandcamp.com/album/ilana-the-creator,SS-051lp,SS-051,602318 136893,,Larry Wilkins,martinsamuel@smith-merritt.com,001-470-109-1601,,Crystal Hobbs,71643 Sandy View Apt. 522,,Warrenton,VA,20186,United States,US,1/14/20,,United States,US,VA,Warrenton,Bing: “mdou moctar”,www.bing.com/search?q=mdou+moctar
162,1/12/20 4:45am,Bandcamp,package,No. 1,Etran de L'Aïr,USD,17.0,1.0,,17.0,,2.0,United States,1.08,paypal,19.0,0.0,3948866938,,1.7,0.0,1.7,0.0,372.16,14.22,Limited Edition LP,,http://etrandelair.bandcamp.com/album/no-1,SS-045lp,SS-045,602318 136824,,Larry Wilkins,hmolina@gmail.com,040.327.6603x44761,,Jonathan Jackson,981 Brown Crossroad,,Warrenton,VA,20186,United States,US,1/14/20,,United States,US,VA,Warrenton,,
163,1/12/20 4:45am,Bandcamp,package,Eghass Malan,Les Filles de Illighadad,USD,17.0,1.0,,17.0,,5.0,United States,,,22.0,0.0,3948866938,,1.7,3.4,0.0,36.52,408.68,15.3,'Eghass Malan' LP,,http://lesfillesdeillighadad.bandcamp.com/album/eghass-malan,SS-044lp-1,SS-044,191515 928351,,Larry Wilkins,gmacias@hotmail.com,966-535-4157x6596,,Michael Harrington,458 Ruiz Meadow Apt. 031,,Warrenton,VA,20186,United States,US,1/14/20,,United States,US,VA,Warrenton,,
164,1/12/20 5:30am,Bandcamp,album,Ilana: The Creator,Mdou Moctar,USD,7.0,1.0,,7.0,,,,0.47,credit card,7.0,0.0,3279601207,,0.7,0.7,0.0,5.83,414.51,5.83,digital download,,http://mdoumoctar.bandcamp.com/album/ilana-the-creator,,SS-051,602318 136893,,Cindy Galloway,mmorgan@hotmail.com,874.478.1363x79984,,Brittney Galvan,87635 Jonathan Lock Apt. 615,,,,,,,,,South Africa,ZA,Western Cape,Cape Town,Bandcamp artist: guidedbyvoices,guidedbyvoices.bandcamp.com/album/zeppelin-over-china
165,1/12/20 5:41am,Bandcamp,package,Eghass Malan,Les Filles de Illighadad,USD,17.0,1.0,,17.0,,5.0,United States,0.72,paypal,22.0,0.0,237534592,,1.7,1.7,0.0,19.58,434.09,14.58,'Eghass Malan' LP,,http://lesfillesdeillighadad.bandcamp.com/album/eghass-malan,SS-044lp-1,SS-044,191515 928351,,William Lopez,charlescunningham@fletcher.com,(865)963-3787x077,,Eric Lopez,4609 Lozano Center,2B,New York,NY,10003,United States,US,1/14/20,,United States,US,NY,New York,,
166,1/12/20 1:14pm,Bandcamp,package,Ilana: The Creator,Mdou Moctar,USD,18.0,2.0,,36.0,,24.0,United States,2.22,credit card,60.0,0.0,833030782,,3.6,3.6,0.0,54.18,488.27,30.18,Ilana LP,,http://mdoumoctar.bandcamp.com/album/ilana-the-creator,SS-051lp,SS-051,602318 136893,,Jennifer Weiss,martindorothy@gmail.com,+1-944-626-9292x7715,,Rebecca Campbell,8592 Williams Island,,Düsseldorf,,40477,Germany,DE,1/14/20,,Germany,DE,,Düsseldorf,Google search,www.google.com/
167,1/12/20 2:32pm,Bandcamp,album,Ilana: The Creator,Mdou Moctar,USD,7.0,1.0,,7.0,1.33,,,0.57,credit card,8.33,0.0,3208909367,,0.7,0.7,0.0,5.73,494.0,5.73,digital download,,http://mdoumoctar.bandcamp.com/album/ilana-the-creator,,SS-051,602318 136893,,Taylor Smith,brittanyfernandez@hotmail.com,484.900.5877x83408,,Vincent Davis,48577 Dakota Flats,,,,,,,,,Germany,DE,Hamburg,Hamburg,ecosia.org,www.ecosia.org/
168,1/12/20 6:02pm,shop@sahelsounds.com,payout,,,USD,,,,,,,,0.49,transfer,49.49,49.0,t250732012,8KH16396WA461814T,,,,-49.49,444.51,,,,,,,,,,,,,,,,,,,,,,,,,,,,
169,1/12/20 6:02pm,shop@sahelsounds.com,payout,,,USD,,,,,,,,1.36,transfer,136.2,134.84,t250732014,8AU4353918355524J,,,,-136.2,308.31,,,,,,,,,,,,,,,,,,,,,,,,,,,,
170,1/12/20 8:32pm,Bandcamp,album,Sousoume Tamachek,Mdou Moctar,USD,7.0,1.0,,7.0,1.75,,,0.86,credit card,8.75,0.0,746908751,,0.7,0.0,0.7,0.0,308.31,5.44,digital download,,http://mdoumoctar.bandcamp.com/album/sousoume-tamachek,,SS-043,191515 769435,,Raymond Walter,jonathan77@hutchinson-melendez.com,(271)906-7636,,Heather Martinez,3899 Daniel Overpass,,,,,,,,,Denmark,DK,Central Jutland,Sunds,Google search,www.google.com/
171,1/12/20 8:32pm,Bandcamp,album,Ilana: The Creator,Mdou Moctar,USD,7.0,1.0,,7.0,1.75,,,,,8.75,0.0,746908751,,0.7,1.4,0.0,11.74,320.05,6.3,digital download,,http://mdoumoctar.bandcamp.com/album/ilana-the-creator,,SS-051,602318 136893,,Raymond Walter,gwilliams@hotmail.com,(010)772-2792,,Susan Bradley,700 Hartman Causeway Apt. 284,,,,,,,,,Denmark,DK,Central Jutland,Sunds,Bandcamp fan wishlist,bandcamp.com/celestialslug
172,1/12/20 9:37pm,Bandcamp,package,Ilana: The Creator,Mdou Moctar,USD,17.0,1.0,,17.0,,5.0,United States,0.78,credit card,22.0,0.0,4081831450,,1.7,1.7,0.0,19.52,339.57,14.52,Ilana LP,,http://mdoumoctar.bandcamp.com/album/ilana-the-creator,SS-051lp,SS-051,602318 136893,,Christopher Morrison,timothylee@gmail.com,7850621895,,Dana Perez,824 Nicole Street Apt. 947,,Burnsville,MN,55337,United States,US,1/14/20,,United States,US,MN,Burnsville,Google search,www.google.com/
173,1/12/20 11:26pm,Bandcamp,package,Ilana: The Creator,Mdou Moctar,USD,17.0,1.0,,17.0,,5.0,United States,0.72,paypal,22.0,0.0,3228302444,,1.7,1.7,0.0,19.58,359.15,14.58,Ilana LP,,http://mdoumoctar.bandcamp.com/album/ilana-the-creator,SS-051lp,SS-051,602318 136893,,Shari Price,nicholas01@yahoo.com,+1-736-422-5757x68558,,Joe English,0212 Gary Locks,,Greenbrier,TN,37073,United States,US,1/14/20,,United States,US,TN,Greenbrier,Google search,www.google.com/
174,1/13/20 12:46am,Bandcamp,package,Sahel Sounds Label Sampler,Various Artists,USD,20.0,1.0,,20.0,,5.0,United States,0.78,paypal,25.0,0.0,2607133501,,2.0,2.0,0.0,22.22,381.37,17.22,Sahel Sounds t-shirt,Medium,http://sahelsounds.bandcamp.com/merch/sahel-sounds-t-shirt,SS-T01-BLK-UMD,,,,Joseph Martin,kathleenjefferson@gmail.com,434.193.2043x22326,,Kenneth Eaton,0502 Patel Brooks Suite 480,,Austin,TX,78745,United States,US,1/14/20,,United States,US,TX,Austin,,
175,1/13/20 2:20am,Bandcamp,album,Ilana: The Creator,Mdou Moctar,USD,8.0,1.0,,8.0,,,,0.45,paypal,8.0,0.0,747398875,,0.8,0.8,0.0,6.75,388.12,6.75,digital download,,http://mdoumoctar.bandcamp.com/album/ilana-the-creator,,SS-051,602318 136893,,Olivia Fisher,wcarr@gmail.com,487.130.6985x73135,,Robert Higgins,162 Bradford Plaza Suite 221,,,,,,,,,United States,US,NJ,Rockaway,duckduckgo.com,duckduckgo.com/
176,1/13/20 3:40am,Bandcamp,package,Afelan,Mdou Moctar,USD,17.0,1.0,,17.0,,5.0,United States,0.72,paypal,22.0,0.0,1030043842,,1.7,1.7,0.0,19.58,407.7,14.58,Afelan LP,,http://mdoumoctar.bandcamp.com/album/afelan,SS-017lp,SS-017,889326 664840,,Evan Edwards,angelabuck@ferguson.com,344.047.1552x845,,Arthur Rios,12852 Tony Dam,15,Santa Cruz,CA,95062,United States,US,1/14/20,,United States,US,CA,Santa Cruz,Bandcamp music feed,http://blog.bandcamp.com/2014/01/30/bandcamp-app-now-with-music-feed/
177,1/13/20 3:49am,Bandcamp,album,Sousoume Tamachek,Mdou Moctar,USD,7.0,1.0,,7.0,,,,0.4,paypal,7.0,0.0,3350033883,,0.7,0.7,0.0,5.9,413.6,5.9,digital download,,http://mdoumoctar.bandcamp.com/album/sousoume-tamachek,,SS-043,191515 769435,,Evan Edwards,sierradickerson@washington.org,8344428829,,John Ellis,9375 Shannon Prairie Apt. 028,,,,,,,,,United States,US,CA,Sacramento,Bandcamp music feed,http://blog.bandcamp.com/2014/01/30/bandcamp-app-now-with-music-feed/
178,1/13/20 3:56am,Bandcamp,package,Eghass Malan,Les Filles de Illighadad,USD,17.0,1.0,,17.0,,5.0,United States,0.72,paypal,22.0,0.0,1528369628,,1.7,1.7,0.0,19.58,433.18,14.58,'Eghass Malan' LP,,http://lesfillesdeillighadad.bandcamp.com/album/eghass-malan,SS-044lp-1,SS-044,191515 928351,,Evan Edwards,qmyers@henry.net,(833)342-6977x249,,Natalie Sandoval,9628 Kelly Route Suite 982,15,Santa Cruz,CA,95062,United States,US,1/14/20,,United States,US,CA,Santa Cruz,Bandcamp music feed,http://blog.bandcamp.com/2014/01/30/bandcamp-app-now-with-music-feed/
179,1/13/20 3:59am,Bandcamp,package,Ilana: The Creator,Mdou Moctar,USD,17.0,1.0,,17.0,,5.0,United States,0.72,paypal,22.0,0.0,2051114425,,1.7,1.7,0.0,19.58,452.76,14.58,Ilana LP,,http://mdoumoctar.bandcamp.com/album/ilana-the-creator,SS-051lp,SS-051,602318 136893,,Jacqueline Mills,hardydavid@johnson.com,422.509.1660,,Kaitlyn Bailey,09518 Price Light Suite 396,,Newnan,GA,30265,United States,US,1/14/20,,United States,US,GA,Newnan,Google search,www.google.com/
180,1/13/20 4:00am,Bandcamp,package,Les Filles de Illighadad,Les Filles de Illighadad,USD,17.0,2.0,,34.0,,7.0,United States,1.08,paypal,41.0,0.0,1607134683,,3.4,3.4,0.0,36.52,489.28,29.52,Les Filles de Illighadad LP,,http://lesfillesdeillighadad.bandcamp.com/album/les-filles-de-illighadad,SS-033-LP,SS-033,889326 664918,,Evan Edwards,charlesdodson@hotmail.com,001-553-435-1336x306,,Nicole Pierce,49612 Christopher Mall Suite 657,15,Santa Cruz,CA,95062,United States,US,1/14/20,,United States,US,CA,Santa Cruz,Bandcamp app discover,bandcamp.com/app/android/discover
181,1/13/20 5:20am,Bandcamp,package,Afelan,Mdou Moctar,USD,17.0,1.0,,17.0,,23.0,United States,1.46,paypal,40.0,0.0,497979077,,1.7,1.7,0.0,36.84,526.12,13.84,Afelan LP,,http://mdoumoctar.bandcamp.com/album/afelan,SS-017lp,SS-017,889326 664840,,Gloria Morris,daniel99@carroll.com,+1-223-693-1045,,Cory Gordon,66845 Laura Avenue,,Perth,WA,6018,Australia,AU,1/14/20,,Australia,AU,WA,Perth,Bandcamp artist: mdoumoctar,mdoumoctar.bandcamp.com/album/afelan
182,1/13/20 6:07am,Bandcamp,album,Ilana: The Creator,Mdou Moctar,USD,10.0,1.0,,10.0,,,,0.52,credit card,10.0,0.0,477802898,,1.0,1.0,0.0,8.48,534.6,8.48,digital download,,http://mdoumoctar.bandcamp.com/album/ilana-the-creator,,SS-051,602318 136893,,Sarah Lee,fbecker@gmail.com,(885)181-6298x7647,,Robert Hayes,423 Charles Brook Suite 568,,,,,,,,,United States,US,CA,Oakland,Bandcamp artist: mdoumoctar,mdoumoctar.bandcamp.com/track/tarhatazed
183,1/13/20 8:25am,Bandcamp,album,Ilana: The Creator,Mdou Moctar,USD,7.0,1.0,,7.0,,,,0.47,paypal,7.0,0.0,3915029592,,0.7,0.7,0.0,5.83,540.43,5.83,digital download,,http://mdoumoctar.bandcamp.com/album/ilana-the-creator,,SS-051,602318 136893,,Todd Bennett,willislindsey@yahoo.com,(368)182-8088,,Anthony Jacobs,32630 Kayla Cape Apt. 178,,,,,,,,,Australia,AU,VIC,Melbourne,rateyourmusic.com (embedded player),rateyourmusic.com/release/album/mdou-moctar/ilana-the-creator/
184,1/13/20 12:57pm,Bandcamp,album,Music from Saharan Cellphones,Various,USD,7.0,1.0,,7.0,1.4,,,0.54,gift card,8.4,0.0,942769193,,0.7,0.7,0.0,5.76,546.19,5.76,digital download,,http://sahelsounds.bandcamp.com/album/music-from-saharan-cellphones,,SS-003,889326 667889,,Bradley Moore,jonathanjohnson@hotmail.com,+1-354-077-5695x89578,,Kimberly Valencia,459 Sanders Ville Apt. 893,,,,,,,,,United Kingdom,GB,Greenwich,Greenwich,Bandcamp artist: sahelsounds,sahelsounds.bandcamp.com/album/music-from-saharan-cellphones
185,1/13/20 6:02pm,shop@sahelsounds.com,payout,,,USD,,,,,,,,0.12,transfer,11.73,11.61,t250954581,1P5885215U874760K,,,,-11.73,534.46,,,,,,,,,,,,,,,,,,,,,,,,,,,,
186,1/13/20 6:02pm,shop@sahelsounds.com,payout,,,USD,,,,,,,,2.97,transfer,296.58,293.61,t250954583,6AJ66631JM361601F,,,,-296.58,237.88,,,,,,,,,,,,,,,,,,,,,,,,,,,,
187,1/13/20 6:14pm,Bandcamp,album,Waande Kadde,Amadou Binta Konté and Tidiane Thiam,USD,7.0,1.0,,7.0,1.4,,,0.57,credit card,8.4,0.0,1414330179,,0.7,0.7,0.0,5.73,243.61,5.73,digital download,,http://sahelsounds.bandcamp.com/album/waande-kadde,,SS-036 / SFH-01,889326 796008,,Emily Glass,fschmitt@yahoo.com,001-853-622-3109,,Sara Gardner,0826 Green Falls,,,,,,,,,United Kingdom,GB,Haringey,Hornsey,Bandcamp fan page: totalvibration,bandcamp.com/totalvibration
188,1/13/20 7:00pm,Bandcamp,album,Ilana: The Creator,Mdou Moctar,USD,8.0,1.0,,8.0,1.33,,,0.57,paypal,9.33,0.0,902582479,,0.8,0.8,0.0,6.63,250.24,6.63,digital download,,http://mdoumoctar.bandcamp.com/album/ilana-the-creator,,SS-051,602318 136893,,Jon Jones,hollandsean@knapp-walsh.org,9717718645,,Chelsea Taylor,0048 James Squares Apt. 496,,,,,,,,,Germany,DE,Hesse,Geisenheim,Bandcamp search,bandcamp.com/app/android/search
189,1/13/20 7:28pm,Bandcamp,package,Ilana: The Creator,Mdou Moctar,USD,30.0,1.0,,30.0,,5.0,United States,0.97,paypal,35.0,0.0,2882295978,,3.0,3.0,0.0,31.03,281.27,26.03,Ilana: The Creator shirt,Large,http://mdoumoctar.bandcamp.com/merch/ilana-the-creator-shirt,SS-MDOU-BIRD-SHIRT-L,,,,Patricia Lawrence,lauraallison@farrell-golden.org,501.791.5773x9884,,William West,59550 Joshua Mountain Apt. 142,16070 Rainbow Drive,Cobb,CA,95426-0136,United States,US,1/14/20,,United States,US,CA,Cobb,"Bandcamp search: “ilana, the creator”",bandcamp.com/search?q=Ilana%2C%20the%20creator
190,1/13/20 8:57pm,Bandcamp,package,Sahel Sounds Label Sampler,Various Artists,USD,20.0,1.0,,20.0,,5.0,United States,0.78,paypal,25.0,0.0,3151107767,,2.0,2.0,0.0,22.22,303.49,17.22,Sahel Sounds t-shirt,Medium,http://sahelsounds.bandcamp.com/merch/sahel-sounds-t-shirt,SS-T01-BLK-UMD,,,,Paul Porter,blanchardjohn@hotmail.com,685.827.6225x6305,,Jennifer Singleton,2894 Hall Summit Apt. 767,,Encino,CA,91316,United States,US,1/14/20,,United States,US,CA,Encino,,
191,1/13/20 10:25pm,Bandcamp,package,Houmeissa,Hama,USD,17.0,1.0,,17.0,,5.0,United States,0.72,paypal,22.0,0.0,3386181204,,1.7,1.7,0.0,19.58,323.07,14.58,Hama - Houmeissa LP,,http://hamasynth.bandcamp.com/album/houmeissa,SS-049lp,SS-049,656605 382364,,Anna Lee,yfox@james-washington.info,880-993-4236x60401,,Clayton Barron,956 David Plains Suite 057,,Grantham,NH,3753,United States,US,1/14/20,,United States,US,NH,Grantham,Twitter,t.co/YNgmDGS3F5?amp=1
192,1/14/20 12:18am,Bandcamp,album,No. 1,Etran de L'Aïr,USD,7.0,1.0,,7.0,1.4,,,0.54,paypal,8.4,0.0,3011962878,,0.7,0.7,0.0,5.76,328.83,5.76,digital download,,http://etrandelair.bandcamp.com/album/no-1,,SS-045,602318 136824,,Jessica Perkins,wedwards@yahoo.com,480-710-5328,,Scott Nguyen,18502 Rush Fork,,,,,,,,,United Kingdom,GB,Waltham Forest,Leyton,Bandcamp search,bandcamp.com/app/ios/search
193,1/14/20 1:06am,Bandcamp,album,Music from Saharan Cellphones,Various,USD,7.0,1.0,,7.0,,,,0.61,credit card,7.0,0.0,1195225944,,0.7,0.0,0.7,0.0,328.83,5.69,digital download,,http://sahelsounds.bandcamp.com/album/music-from-saharan-cellphones,,SS-003,889326 667889,,Tamara Williams,nweber@good.org,001-364-308-5990,,William Barry,8840 David Tunnel Suite 357,,,,,,,,,United States,US,NH,Littleton,t.umblr.com,t.umblr.com/
194,1/14/20 1:06am,Bandcamp,album,Music from Saharan Cellphones: Volume 2,Various,USD,7.0,1.0,,7.0,,,,,,7.0,0.0,1195225944,,0.7,1.4,0.0,11.99,340.82,6.3,digital download,,http://sahelsounds.bandcamp.com/album/music-from-saharan-cellphones-volume-2,,SS-012,889326 667742,,Tamara Williams,hannahguzman@russell.info,015.121.3270,,Kelsey Reed,108 Ellen Burgs,,,,,,,,,United States,US,NH,Littleton,Google search,www.google.com/
195,1/14/20 2:33am,Bandcamp,album,Music from Saharan Cellphones,Various,USD,7.0,1.0,,7.0,,,,0.4,paypal,7.0,0.0,2985005935,,0.7,0.7,0.0,5.9,346.72,5.9,digital download,,http://sahelsounds.bandcamp.com/album/music-from-saharan-cellphones,,SS-003,889326 667889,,Jeremy Wright,tylertate@hotmail.com,453.139.6941,,Donna Chavez,326 Edward Avenue,,,,,,,,,United States,US,CA,North Hollywood,,
196,1/14/20 8:54am,Bandcamp,album,Ilana: The Creator,Mdou Moctar,USD,10.0,1.0,,10.0,1.4,,,0.63,paypal,11.4,0.0,2567601167,,1.0,1.0,0.0,8.37,355.09,8.37,digital download,,http://mdoumoctar.bandcamp.com/album/ilana-the-creator,,SS-051,602318 136893,,Shane English,bradley65@cruz.org,+1-344-465-1142x41456,,Angela Mccarthy,399 Carlson Prairie,,,,,,,,,United Kingdom,GB,,,Bandcamp search,bandcamp.com/app/android/search
197,1/14/20 9:13am,Bandcamp,package,Ilana: The Creator,Mdou Moctar,USD,12.0,1.0,,12.0,,10.0,United States,1.0,credit card,22.0,0.0,11072729,,1.2,1.2,0.0,19.8,374.89,9.8,Ilana: The Creator CD,,http://mdoumoctar.bandcamp.com/album/ilana-the-creator,SS-051cd,SS-051,602318 136893,,Nicole Chandler,brooksmichael@hotmail.com,001-671-956-0863x4377,,Jillian Mccall,413 Cassandra Locks,,Zakopane,Malopolska,34-500,Poland,PL,1/14/20,,Poland,PL,Malopolska,Zakopane,Google search,www.google.com/
198,1/14/20 3:29pm,Bandcamp,album,Eghass Malan,Les Filles de Illighadad,USD,7.0,1.0,,7.0,,,,0.47,credit card,7.0,0.0,2343999342,,0.7,0.7,0.0,5.83,380.72,5.83,digital download,,http://lesfillesdeillighadad.bandcamp.com/album/eghass-malan,,SS-044,191515 928351,,Steven Greer,mgonzalez@yahoo.com,8787566838,,Kristina Davis,347 Savannah Bridge,,,,,,,,,Mexico,MX,Puebla,Puebla City,Bandcamp Discover,bandcamp.com/#discover
199,1/14/20 6:02pm,shop@sahelsounds.com,payout,,,USD,,,,,,,,2.19,transfer,219.4,217.21,t251185454,4U160583M53038041,,,,-219.4,161.32,,,,,,,,,,,,,,,,,,,,,,,,,,,,
200,1/14/20 6:02pm,shop@sahelsounds.com,payout,,,USD,,,,,,,,0.18,transfer,18.48,18.3,t251185457,43P7035709670013B,,,,-18.48,142.84,,,,,,,,,,,,,,,,,,,,,,,,,,,,
201,1/15/20 1:09am,Bandcamp,package,Ilana: The Creator,Mdou Moctar,USD,17.0,1.0,,17.0,,5.0,United States,1.0,credit card,22.0,0.0,1241747792,,1.7,1.7,0.0,19.3,162.14,14.3,Ilana LP,,http://mdoumoctar.bandcamp.com/album/ilana-the-creator,SS-051lp,SS-051,602318 136893,,Gregory Williams,efitzgerald@nguyen-robinson.org,+1-580-167-8177,,Allison Knight,109 Martin Plain Apt. 428,,SALT LAKE CITY,UT,84102-3807,United States,US,1/21/20,,United States,US,UT,SALT LAKE CITY,Google search,www.google.com/
202,1/15/20 1:35am,Bandcamp,album,Tiris,El Wali,USD,7.0,1.0,,7.0,,,,0.4,paypal,7.0,0.0,82713311,,0.7,0.7,0.0,5.9,168.04,5.9,digital download,,http://elwali.bandcamp.com/album/tiris,,SS-055,602318 136923,,Deborah Glass,donovanstephen@yahoo.com,+1-322-740-7892x8814,,Amy Gomez,08128 Lynch Divide,,,,,,,,,United States,US,OH,Cincinnati,,
203,1/15/20 1:52am,Bandcamp,album,Ilana: The Creator,Mdou Moctar,USD,10.0,1.0,,10.0,,,,0.49,paypal,10.0,0.0,3979516380,,1.0,1.0,0.0,8.51,176.55,8.51,digital download,,http://mdoumoctar.bandcamp.com/album/ilana-the-creator,,SS-051,602318 136893,,Shannon Gonzalez,lopezgreg@weaver.com,239.158.1154x19361,,Laura Mejia,462 Lisa Rest,,,,,,,,,United States,US,CA,Lomita,Bandcamp search,bandcamp.com/autocomplete-search
204,1/15/20 2:05am,Bandcamp,album,Sahel Sounds Label Sampler,Various Artists,USD,2.0,1.0,,2.0,,,,0.17,credit card,2.0,0.0,2690138241,,0.2,0.2,0.0,1.63,178.18,1.63,digital download,,http://sahelsounds.bandcamp.com/album/sahel-sounds-label-sampler,,SS-058,602318 137111,,Nicole Campbell,stevensonyvette@gonzalez-vargas.com,029.826.6121x872,,Ashley Soto,2319 Robert Turnpike Suite 307,,,,,,,,,Canada,CA,BC,Kamloops,,
205,1/15/20 6:35am,Bandcamp,album,Music from Saharan WhatsApp,Etran de L'Aïr,USD,1.0,1.0,,1.0,,,,0.11,paypal,1.0,0.0,2001312212,,0.1,0.1,0.0,0.79,178.97,0.79,digital download,,http://etrandelair.bandcamp.com/album/music-from-saharan-whatsapp,,WHATSAPP-01,,,Julie Garcia,patrick47@yahoo.com,001-950-199-6280x647,,Paula Terry,44240 Christopher Pines Apt. 563,,,,,,,,,Netherlands,NL,North Holland,Amsterdam,Publish notice sent to your fans,
206,1/15/20 6:39am,Bandcamp,album,Music from Saharan WhatsApp,Etran de L'Aïr,USD,4.0,1.0,,4.0,,,,0.25,paypal,4.0,0.0,3519012387,,0.4,0.4,0.0,3.35,182.32,3.35,digital download,,http://etrandelair.bandcamp.com/album/music-from-saharan-whatsapp,,WHATSAPP-01,,,Travis Rangel,greenjoel@hernandez.org,259.996.5989x097,,Brooke Harris,66145 Roman Fort,,,,,,,,,United States,US,CA,Milpitas,Publish notice sent to your fans,
207,1/15/20 6:56am,Bandcamp,album,Music from Saharan WhatsApp,Etran de L'Aïr,USD,2.0,1.0,,2.0,,,,0.15,credit card,2.0,0.0,802950101,,0.2,0.2,0.0,1.65,183.97,1.65,digital download,,http://etrandelair.bandcamp.com/album/music-from-saharan-whatsapp,,WHATSAPP-01,,,Daniel Carroll,rubenlong@yahoo.com,+1-390-944-8197x0576,,Julie Ellis,7294 Daniel Ridges Apt. 722,,,,,,,,,United States,US,CA,San Francisco,Publish notice sent to your fans,
208,1/15/20 6:57am,Bandcamp,album,Music from Saharan WhatsApp,Etran de L'Aïr,USD,5.0,1.0,,5.0,,,,0.35,paypal,5.0,0.0,865783110,,0.5,0.5,0.0,4.15,188.12,4.15,digital download,,http://etrandelair.bandcamp.com/album/music-from-saharan-whatsapp,,WHATSAPP-01,,,Rachel Simpson,npetersen@gutierrez.biz,(729)725-2851,,John Chan,04866 Ward Islands Apt. 429,,,,,,,,,Netherlands,NL,Provincie Overijssel,Almelo,Publish notice sent to your fans,
209,1/15/20 7:01am,Bandcamp,album,Music from Saharan WhatsApp,Etran de L'Aïr,USD,1.0,1.0,,1.0,,,,0.11,credit card,1.0,0.0,978369834,,0.1,0.1,0.0,0.79,188.91,0.79,digital download,,http://etrandelair.bandcamp.com/album/music-from-saharan-whatsapp,,WHATSAPP-01,,,Chris Burton,taylorwendy@hotmail.com,001-857-080-9089,,Oscar Cruz,3468 Michelle Landing,,,,,,,,,United Kingdom,GB,Renfrewshire,Paisley,Publish notice sent to your fans,
210,1/15/20 7:26am,Bandcamp,album,Music from Saharan WhatsApp,Etran de L'Aïr,USD,1.0,1.0,,1.0,,,,0.11,paypal,1.0,0.0,3305866122,,0.1,0.1,0.0,0.79,189.7,0.79,digital download,,http://etrandelair.bandcamp.com/album/music-from-saharan-whatsapp,,WHATSAPP-01,,,Anna Carpenter,rrichardson@harvey.com,844-788-7006,,Angela Elliott,04702 Elizabeth Land Suite 860,,,,,,,,,Japan,JP,Tokyo,Meguro-ku,Publish notice sent to your fans,
211,1/15/20 7:32am,Bandcamp,album,No. 1,Etran de L'Aïr,USD,7.0,1.0,,7.0,,,,0.49,paypal,7.0,0.0,882688755,,0.7,0.0,0.7,0.0,189.7,5.81,digital download,,http://etrandelair.bandcamp.com/album/no-1,,SS-045,602318 136824,,Haley Robinson,silvaveronica@anderson.net,(634)915-9336x46372,,Jennifer Parker,73198 Christopher Lakes,,,,,,,,,United States,US,CA,Santa Monica,Publish notice sent to your fans,
212,1/15/20 7:32am,Bandcamp,album,Music from Saharan WhatsApp,Etran de L'Aïr,USD,3.0,1.0,,3.0,,,,,,3.0,0.0,882688755,,0.3,1.0,0.0,8.51,198.21,2.7,digital download,,http://etrandelair.bandcamp.com/album/music-from-saharan-whatsapp,,WHATSAPP-01,,,Haley Robinson,murphysarah@yahoo.com,001-903-786-7714x7493,,Michael Brandt,17248 John Orchard Apt. 530,,,,,,,,,United States,US,CA,Santa Monica,,
213,1/15/20 7:36am,Bandcamp,album,Music from Saharan WhatsApp,Etran de L'Aïr,USD,4.0,1.0,,4.0,,,,0.29,paypal,4.0,0.0,3149768939,,0.4,0.4,0.0,3.31,201.52,3.31,digital download,,http://etrandelair.bandcamp.com/album/music-from-saharan-whatsapp,,WHATSAPP-01,,,Joshua Carter,asmith@murray.com,+1-575-867-2416,,Alex Mason,505 Knox Extension,,,,,,,,,United Kingdom,GB,,,Publish notice sent to your fans,
214,1/15/20 8:10am,Bandcamp,album,Music from Saharan WhatsApp,Etran de L'Aïr,USD,2.5,1.0,,2.5,,,,0.2,paypal,2.5,0.0,2001143784,,0.25,0.25,0.0,2.05,203.57,2.05,digital download,,http://etrandelair.bandcamp.com/album/music-from-saharan-whatsapp,,WHATSAPP-01,,,Kimberly Harrington,piercedevin@yahoo.com,(245)030-6361x02753,,Paige Warren,247 Timothy Points Suite 355,,,,,,,,,Netherlands,NL,Provincie Utrecht,Utrecht,Publish notice sent to your fans,
215,1/15/20 8:28am,Bandcamp,album,Music from Saharan WhatsApp,Etran de L'Aïr,USD,3.0,1.0,,3.0,,,,0.23,credit card,3.0,0.0,167018893,,0.3,0.3,0.0,2.47,206.04,2.47,digital download,,http://etrandelair.bandcamp.com/album/music-from-saharan-whatsapp,,WHATSAPP-01,,,Stacey Chapman,jamie36@cooper.com,299-462-4603x64103,,Tyler Long,943 Jones Drive Suite 527,,,,,,,,,Poland,PL,Lesser Poland,Krakow,Publish notice sent to your fans,
216,1/15/20 8:47am,Bandcamp,album,Music from Saharan WhatsApp,Etran de L'Aïr,USD,2.0,1.0,,2.0,,,,0.17,paypal,2.0,0.0,3563250365,,0.2,0.2,0.0,1.63,207.67,1.63,digital download,,http://etrandelair.bandcamp.com/album/music-from-saharan-whatsapp,,WHATSAPP-01,,,Michael Vargas,smithmaureen@yahoo.com,001-617-488-9136x509,,Erika Salazar,4585 Thomas Crossing Suite 215,,,,,,,,,United Kingdom,GB,Redbridge,Ilford,Publish notice sent to your fans,
217,1/15/20 8:51am,Bandcamp,album,Music from Saharan WhatsApp,Etran de L'Aïr,USD,1.0,1.0,,1.0,,,,0.11,paypal,1.0,0.0,3418493220,,0.1,0.1,0.0,0.79,208.46,0.79,digital download,,http://etrandelair.bandcamp.com/album/music-from-saharan-whatsapp,,WHATSAPP-01,,,Mandy Jordan,goodwintracy@robles-reyes.com,001-985-845-5226x412,,Erin Donovan,740 Green Lock Suite 664,,,,,,,,,Finland,FI,Uusimaa,Helsinki,Publish notice sent to your fans,
218,1/15/20 9:30am,Bandcamp,album,Music from Saharan WhatsApp,Etran de L'Aïr,USD,3.0,1.0,,3.0,,,,0.2,paypal,3.0,0.0,3429419636,,0.3,0.3,0.0,2.5,210.96,2.5,digital download,,http://etrandelair.bandcamp.com/album/music-from-saharan-whatsapp,,WHATSAPP-01,,,Susan Moore,troy88@arnold-clark.com,925.423.8781x855,,Jose Harding,909 Reynolds Mountains Suite 510,,,,,,,,,Saudi Arabia,SA,Makkah Province,Thuwal,Bandcamp search,bandcamp.com/autocomplete-search
219,1/15/20 9:37am,Bandcamp,album,Music from Saharan WhatsApp,Etran de L'Aïr,USD,1.0,1.0,,1.0,,,,0.11,paypal,1.0,0.0,72109314,,0.1,0.1,0.0,0.79,211.75,0.79,digital download,,http://etrandelair.bandcamp.com/album/music-from-saharan-whatsapp,,WHATSAPP-01,,,Mike Bentley,michael79@hotmail.com,001-229-871-4131,,Erik Ramos,08760 Lamb Points,,,,,,,,,United Kingdom,GB,Rochdale,Rochdale,Publish notice sent to your fans,
220,1/15/20 9:37am,Bandcamp,album,Music from Saharan WhatsApp,Etran de L'Aïr,USD,1.0,1.0,,1.0,,,,0.11,paypal,1.0,0.0,568724775,,0.1,0.1,0.0,0.79,212.54,0.79,digital download,,http://etrandelair.bandcamp.com/album/music-from-saharan-whatsapp,,WHATSAPP-01,,,Lisa Vincent,reginashaw@gmail.com,982-367-1122,,Christopher Hill,565 Lisa Forges,,,,,,,,,United Kingdom,GB,Ceredigion,Cardigan,Publish notice sent to your fans,
221,1/15/20 9:54am,Bandcamp,album,Music from Saharan WhatsApp,Etran de L'Aïr,USD,4.0,1.0,,4.0,,,,0.29,paypal,4.0,0.0,3322326556,,0.4,0.4,0.0,3.31,215.85,3.31,digital download,,http://etrandelair.bandcamp.com/album/music-from-saharan-whatsapp,,WHATSAPP-01,,,Paul Valdez,robert54@yahoo.com,001-157-247-2143x0802,,Benjamin Roberts,421 Jackson Causeway,,,,,,,,,United Kingdom,GB,England,London,Publish notice sent to your fans,
222,1/15/20 9:54am,Bandcamp,album,Music from Saharan WhatsApp,Etran de L'Aïr,USD,1.0,1.0,,1.0,,,,0.11,paypal,1.0,0.0,3235292206,,0.1,0.1,0.0,0.79,216.64,0.79,digital download,,http://etrandelair.bandcamp.com/album/music-from-saharan-whatsapp,,WHATSAPP-01,,,Kathleen Torres,jamesmeyer@gmail.com,(358)435-7813x32302,,Sherri Drake,92261 Courtney Avenue,,,,,,,,,Portugal,PT,Porto,Porto,Publish notice sent to your fans,
223,1/15/20 9:58am,Bandcamp,album,Music from Saharan WhatsApp,Etran de L'Aïr,USD,3.0,1.0,,3.0,,,,0.2,paypal,3.0,0.0,2894320791,,0.3,0.3,0.0,2.5,219.14,2.5,digital download,,http://etrandelair.bandcamp.com/album/music-from-saharan-whatsapp,,WHATSAPP-01,,,Mark Rodriguez,ythomas@yahoo.com,+1-340-338-4397x85756,,Sean Sanchez,95157 Jonathan Park Suite 334,,,,,,,,,Turkey,TR,Istanbul,Istanbul,Publish notice sent to your fans,
224,1/15/20 10:01am,Bandcamp,album,Music from Saharan WhatsApp,Etran de L'Aïr,USD,1.0,1.0,,1.0,,,,0.11,paypal,1.0,0.0,954747675,,0.1,0.1,0.0,0.79,219.93,0.79,digital download,,http://etrandelair.bandcamp.com/album/music-from-saharan-whatsapp,,WHATSAPP-01,,,Adriana Shepard,kgutierrez@yahoo.com,(584)279-0081,,Richard Floyd,06964 Angel Forge,,,,,,,,,Belgium,BE,Antwerp Province,Edegem,Bandcamp search,bandcamp.com/autocomplete-search
225,1/15/20 10:44am,Bandcamp,album,Music from Saharan WhatsApp,Etran de L'Aïr,USD,1.5,1.0,,1.5,,,,0.14,credit card,1.5,0.0,907235083,,0.15,0.15,0.0,1.21,221.14,1.21,digital download,,http://etrandelair.bandcamp.com/album/music-from-saharan-whatsapp,,WHATSAPP-01,,,Candice Wilson,lgutierrez@pena-miranda.com,001-427-873-0990x164,,Jason Mcdonald,25569 Maureen Trafficway Suite 366,,,,,,,,,United Kingdom,GB,Glasgow City,Glasgow,Publish notice sent to your fans,
226,1/15/20 11:36am,Bandcamp,album,Music from Saharan WhatsApp,Etran de L'Aïr,USD,2.0,1.0,,2.0,,,,0.17,credit card,2.0,0.0,2736149712,,0.2,0.2,0.0,1.63,222.77,1.63,digital download,,http://etrandelair.bandcamp.com/album/music-from-saharan-whatsapp,,WHATSAPP-01,,,Karen Mcbride,danielcarson@gmail.com,(062)362-8778,,David Cervantes,823 Elizabeth Spring,,,,,,,,,Brazil,BR,Paraíba,João Pessoa,Publish notice sent to your fans,
227,1/15/20 11:47am,Bandcamp,album,Music from Saharan WhatsApp,Etran de L'Aïr,USD,3.0,1.0,,3.0,,,,0.23,paypal,3.0,0.0,2811880502,,0.3,0.3,0.0,2.47,225.24,2.47,digital download,,http://etrandelair.bandcamp.com/album/music-from-saharan-whatsapp,,WHATSAPP-01,,,Stephanie Dominguez,valerie56@hotmail.com,(342)433-1943,,Heather Valenzuela,589 Adam Springs Apt. 192,,,,,,,,,Spain,ES,Malaga,Málaga,Publish notice sent to your fans,
228,1/15/20 12:02pm,Bandcamp,album,Music from Saharan WhatsApp,Etran de L'Aïr,USD,3.0,1.0,,3.0,,,,0.2,paypal,3.0,0.0,1872635846,,0.3,0.3,0.0,2.5,227.74,2.5,digital download,,http://etrandelair.bandcamp.com/album/music-from-saharan-whatsapp,,WHATSAPP-01,,,Chelsey Williams,sharonwilson@hotmail.com,001-951-296-1108x3932,,John Lee,639 Pope Inlet Suite 502,,,,,,,,,United States,US,NY,Rochester,Publish notice sent to your fans,
229,1/15/20 12:43pm,Bandcamp,album,Music from Saharan WhatsApp,Etran de L'Aïr,USD,6.0,1.0,,6.0,,,,0.35,credit card,6.0,0.0,3807082022,,0.6,0.6,0.0,5.05,232.79,5.05,digital download,,http://etrandelair.bandcamp.com/album/music-from-saharan-whatsapp,,WHATSAPP-01,,,Tonya Mitchell,cynthia05@yahoo.com,053-667-1803x60606,,Keith Schmidt,5482 Herring Harbor,,,,,,,,,United States,US,IA,Des Moines,Publish notice sent to your fans,
230,1/15/20 12:52pm,Bandcamp,album,Music from Saharan WhatsApp,Etran de L'Aïr,USD,6.0,1.0,,6.0,,,,0.35,paypal,6.0,0.0,116447231,,0.6,0.6,0.0,5.05,237.84,5.05,digital download,,http://etrandelair.bandcamp.com/album/music-from-saharan-whatsapp,,WHATSAPP-01,,,Ivan Murray,rosalesemily@torres.info,+1-607-826-2828x691,,Andrew Palmer,0562 Mosley Groves Apt. 091,,,,,,,,,United States,US,GA,Atlanta,Publish notice sent to your fans,
231,1/15/20 12:53pm,Bandcamp,album,Music from Saharan WhatsApp,Etran de L'Aïr,USD,4.0,1.0,,4.0,,,,0.29,paypal,4.0,0.0,1995615105,,0.4,0.4,0.0,3.31,241.15,3.31,digital download,,http://etrandelair.bandcamp.com/album/music-from-saharan-whatsapp,,WHATSAPP-01,,,Richard Owens,mcdonaldsteven@weaver-pineda.com,(374)827-4070,,Christopher Morales,4875 Lane Burg Apt. 927,,,,,,,,,United Kingdom,GB,Trafford,Sale,Publish notice sent to your fans,
232,1/15/20 12:56pm,Bandcamp,album,Music from Saharan WhatsApp,Etran de L'Aïr,USD,3.0,1.0,,3.0,,,,0.2,paypal,3.0,0.0,3673176866,,0.3,0.3,0.0,2.5,243.65,2.5,digital download,,http://etrandelair.bandcamp.com/album/music-from-saharan-whatsapp,,WHATSAPP-01,,,Christine Knight,tarahutchinson@church-humphrey.biz,+1-855-315-6937x866,,April Curry,102 Gabriel Light Apt. 141,,,,,,,,,United States,US,OH,Lakewood,Publish notice sent to your fans,
233,1/15/20 1:01pm,Bandcamp,album,Music from Saharan WhatsApp,Etran de L'Aïr,USD,5.0,1.0,,5.0,,,,0.3,credit card,5.0,0.0,1767652093,,0.5,0.5,0.0,4.2,247.85,4.2,digital download,,http://etrandelair.bandcamp.com/album/music-from-saharan-whatsapp,,WHATSAPP-01,,,Dustin Blackwell,aprilbyrd@gmail.com,587-121-4703x48486,,Robin Martin,8212 Day Village Suite 486,,,,,,,,,United States,US,IL,Chicago,Publish notice sent to your fans,
234,1/15/20 1:10pm,Bandcamp,album,Music from Saharan WhatsApp,Etran de L'Aïr,USD,1.0,1.0,,1.0,,,,0.1,paypal,1.0,0.0,2598409239,,0.1,0.1,0.0,0.8,248.65,0.8,digital download,,http://etrandelair.bandcamp.com/album/music-from-saharan-whatsapp,,WHATSAPP-01,,,Kristy Martinez,camposerin@hall.biz,497-537-9698,,Dennis Rodriguez,6008 Crawford Flat,,,,,,,,,United States,US,IL,Chicago,Publish notice sent to your fans,
235,1/15/20 1:28pm,Bandcamp,album,Music from Saharan WhatsApp,Etran de L'Aïr,USD,3.0,1.0,,3.0,,,,0.2,paypal,3.0,0.0,3830481284,,0.3,0.3,0.0,2.5,251.15,2.5,digital download,,http://etrandelair.bandcamp.com/album/music-from-saharan-whatsapp,,WHATSAPP-01,,,Darren Howard,joelvargas@hotmail.com,001-729-484-8052x4062,,Courtney Le,5098 Warner Branch,,,,,,,,,United States,US,MO,St Louis,Publish notice sent to your fans,
236,1/15/20 1:43pm,Bandcamp,album,Music from Saharan WhatsApp,Etran de L'Aïr,USD,10.0,1.0,,10.0,,,,0.49,paypal,10.0,0.0,1885188699,,1.0,1.0,0.0,8.51,259.66,8.51,digital download,,http://etrandelair.bandcamp.com/album/music-from-saharan-whatsapp,,WHATSAPP-01,,,Candace Tate,ninahoffman@palmer.org,+1-083-710-4826x462,,Leslie Pratt,8932 Kyle Mall,,,,,,,,,United States,US,NJ,Montclair,Publish notice sent to your fans,
237,1/15/20 1:45pm,Bandcamp,album,Music from Saharan WhatsApp,Etran de L'Aïr,USD,1.0,1.0,,1.0,,,,0.1,paypal,1.0,0.0,2089430216,,0.1,0.1,0.0,0.8,260.46,0.8,digital download,,http://etrandelair.bandcamp.com/album/music-from-saharan-whatsapp,,WHATSAPP-01,,,Gary Hendricks,weavermatthew@yahoo.com,8041552294,,Brian Brewer,5772 Katie Corner Apt. 693,,,,,,,,,United States,US,NY,New York,Publish notice sent to your fans,
238,1/15/20 1:47pm,Bandcamp,album,Music from Saharan WhatsApp,Etran de L'Aïr,USD,2.0,1.0,,2.0,,,,0.17,paypal,2.0,0.0,4043882216,,0.2,0.2,0.0,1.63,262.09,1.63,digital download,,http://etrandelair.bandcamp.com/album/music-from-saharan-whatsapp,,WHATSAPP-01,,,Tracy Kerr,oli@burns.net,604.102.4594,,Jessica Lawrence,1339 Jonathan Cliffs,,,,,,,,,Netherlands,NL,South Holland,Zuidland,Publish notice sent to your fans,
239,1/15/20 2:15pm,Bandcamp,album,Music from Saharan WhatsApp,Etran de L'Aïr,USD,5.0,1.0,,5.0,,,,0.35,credit card,5.0,0.0,1281336173,,0.5,0.5,0.0,4.15,266.24,4.15,digital download,,http://etrandelair.bandcamp.com/album/music-from-saharan-whatsapp,,WHATSAPP-01,,,Courtney Cooper,landrywilliam@harris.com,779-287-7534x37009,,Justin Fritz,3466 Gutierrez Unions,,,,,,,,,Italy,IT,Rome,Rome,,
240,1/15/20 2:16pm,Bandcamp,album,Music from Saharan WhatsApp,Etran de L'Aïr,USD,1.0,1.0,,1.0,,,,0.11,credit card,1.0,0.0,1841981827,,0.1,0.1,0.0,0.79,267.03,0.79,digital download,,http://etrandelair.bandcamp.com/album/music-from-saharan-whatsapp,,WHATSAPP-01,,,Kristen Wilson,rpierce@gmail.com,053.086.1849x6052,,Jessica Stone,83042 Martinez Station,,,,,,,,,Canada,CA,ON,Ottawa,Publish notice sent to your fans,
241,1/15/20 2:43pm,Bandcamp,album,Music from Saharan WhatsApp,Etran de L'Aïr,USD,8.0,1.0,,8.0,,,,0.45,credit card,8.0,0.0,3198851042,,0.8,0.8,0.0,6.75,273.78,6.75,digital download,,http://etrandelair.bandcamp.com/album/music-from-saharan-whatsapp,,WHATSAPP-01,,,Ian Collins,gavinnelson@yahoo.com,(203)295-8563x38370,,Timothy Richardson,05600 Warren Ridge Apt. 457,,,,,,,,,United States,US,NY,New York,Publish notice sent to your fans,
242,1/15/20 2:54pm,Bandcamp,album,Music from Saharan WhatsApp,Etran de L'Aïr,USD,2.0,1.0,,2.0,,,,0.15,paypal,2.0,0.0,2265274454,,0.2,0.2,0.0,1.65,275.43,1.65,digital download,,http://etrandelair.bandcamp.com/album/music-from-saharan-whatsapp,,WHATSAPP-01,,,Patricia Davis,williamsmelissa@hotmail.com,673.298.2996,,John Walker,0279 Andrew Island,,,,,,,,,United States,US,TX,Dallas,Publish notice sent to your fans,
243,1/15/20 3:13pm,Bandcamp,album,Music from Saharan WhatsApp,Etran de L'Aïr,USD,1.0,1.0,,1.0,,,,0.11,paypal,1.0,0.0,3430090580,,0.1,0.1,0.0,0.79,276.22,0.79,digital download,,http://etrandelair.bandcamp.com/album/music-from-saharan-whatsapp,,WHATSAPP-01,,,Kevin Ray,hpatton@yahoo.com,3818480632,,Samantha Nichols,1960 Simon Ridges,,,,,,,,,Ireland,IE,Leinster,Dublin,Publish notice sent to your fans,
244,1/15/20 4:15pm,Bandcamp,album,Music from Saharan WhatsApp,Etran de L'Aïr,USD,1.0,1.0,,1.0,,,,0.1,paypal,1.0,0.0,3140815577,,0.1,0.1,0.0,0.8,277.02,0.8,digital download,,http://etrandelair.bandcamp.com/album/music-from-saharan-whatsapp,,WHATSAPP-01,,,Richard Garcia,kmartinez@yahoo.com,001-194-904-2402x5550,,Samuel Wright,342 Traci Summit Apt. 944,,,,,,,,,United States,US,NJ,Secaucus,Publish notice sent to your fans,
245,1/15/20 4:16pm,Bandcamp,album,Music from Saharan WhatsApp,Etran de L'Aïr,USD,5.0,1.0,,5.0,,,,0.3,credit card,5.0,0.0,2175775033,,0.5,0.5,0.0,4.2,281.22,4.2,digital download,,http://etrandelair.bandcamp.com/album/music-from-saharan-whatsapp,,WHATSAPP-01,,,Kathryn Carter,steven88@torres.com,801-143-4765x05639,,Joshua Ortega,802 Kristin Trail Suite 918,,,,,,,,,United States,US,NY,New York,Publish notice sent to your fans,
246,1/15/20 4:26pm,Bandcamp,track,Anou Malane,Abdallah Ag Oumbadougou,USD,1.0,1.0,,1.0,,,,0.1,credit card,1.0,0.0,3992865020,,0.1,0.1,0.0,0.8,282.02,0.8,digital download,,http://abdallahagoumbadougou.bandcamp.com/track/anou-malane,,SS-053,,,Frances Santana,bauerrhonda@gmail.com,264.937.9670,,Monica Gutierrez,5915 Jeffery Rapid,,,,,,,,,United States,US,VA,Charlottesville,Bandcamp Daily: best-reissues-on-bandcamp-august-september-2019,daily.bandcamp.com/best-reissues/best-reissues-on-bandcamp-august-september-2019
247,1/15/20 4:30pm,Bandcamp,album,Music from Saharan WhatsApp,Etran de L'Aïr,USD,5.0,1.0,,5.0,,,,0.35,paypal,5.0,0.0,2963049445,,0.5,0.5,0.0,4.15,286.17,4.15,digital download,,http://etrandelair.bandcamp.com/album/music-from-saharan-whatsapp,,WHATSAPP-01,,,Patricia Oneal,cameron41@yahoo.com,+1-031-569-3996x7906,,Matthew Conrad,8947 Kevin Ports Apt. 173,,,,,,,,,Germany,DE,,,Bandcamp music feed,http://blog.bandcamp.com/2014/01/30/bandcamp-app-now-with-music-feed/
248,1/15/20 4:34pm,Bandcamp,album,Music from Saharan WhatsApp,Etran de L'Aïr,USD,4.0,1.0,,4.0,,,,0.25,paypal,4.0,0.0,3103142064,,0.4,0.4,0.0,3.35,289.52,3.35,digital download,,http://etrandelair.bandcamp.com/album/music-from-saharan-whatsapp,,WHATSAPP-01,,,Anthony White,npearson@hotmail.com,+1-807-225-3469x3581,,Gregory Smith,254 Jeffrey Loop Suite 395,,,,,,,,,United States,US,CT,Willimantic,Publish notice sent to your fans,
249,1/15/20 4:54pm,Bandcamp,album,Ilana: The Creator,Mdou Moctar,USD,7.0,1.0,,7.0,,,,0.4,paypal,7.0,0.0,3684179893,,0.7,0.7,0.0,5.9,295.42,5.9,digital download,,http://mdoumoctar.bandcamp.com/album/ilana-the-creator,,SS-051,602318 136893,,Ashley Navarro,yolanda05@yahoo.com,001-793-936-4854x337,,Joshua Robinson,445 Wyatt Lights Apt. 492,,,,,,,,,United States,US,FL,Jacksonville,,
250,1/15/20 4:58pm,Bandcamp,album,Music from Saharan WhatsApp,Etran de L'Aïr,USD,5.0,1.0,,5.0,,,,0.3,paypal,5.0,0.0,2860610378,,0.5,0.5,0.0,4.2,299.62,4.2,digital download,,http://etrandelair.bandcamp.com/album/music-from-saharan-whatsapp,,WHATSAPP-01,,,Michael Nichols,jperez@hotmail.com,+1-999-648-0192x45795,,Lisa Richard,684 Hartman Harbors,,,,,,,,,United States,US,CA,Oakland,,
251,1/15/20 5:11pm,Bandcamp,album,Music from Saharan WhatsApp,Etran de L'Aïr,USD,10.0,1.0,,10.0,,,,0.52,credit card,10.0,0.0,890641298,,1.0,1.0,0.0,8.48,308.1,8.48,digital download,,http://etrandelair.bandcamp.com/album/music-from-saharan-whatsapp,,WHATSAPP-01,,,Timothy Dodson,landerson@ross.com,331-519-9987x4696,,Dylan Evans,791 Calderon Wall Suite 418,,,,,,,,,United States,US,PA,Philadelphia,Publish notice sent to your fans,
252,1/15/20 5:20pm,Bandcamp,album,Music from Saharan WhatsApp,Etran de L'Aïr,USD,8.0,1.0,,8.0,,,,0.45,credit card,8.0,0.0,2553711558,,0.8,0.8,0.0,6.75,314.85,6.75,digital download,,http://etrandelair.bandcamp.com/album/music-from-saharan-whatsapp,,WHATSAPP-01,,,Brandon Schneider,travisgaines@james.com,802.036.0784x3538,,Emily Thompson,225 David Village Apt. 904,,,,,,,,,United States,US,OR,Portland,Bandcamp search: “etran de l'air”,bandcamp.com/search?q=etran%20de%20l%27air
253,1/15/20 5:23pm,Bandcamp,album,Music from Saharan WhatsApp,Etran de L'Aïr,USD,4.0,1.0,,4.0,,,,0.29,paypal,4.0,0.0,1742786514,,0.4,0.4,0.0,3.31,318.16,3.31,digital download,,http://etrandelair.bandcamp.com/album/music-from-saharan-whatsapp,,WHATSAPP-01,,,Michael Carney,morrisgary@yahoo.com,(684)921-2715,,George Reeves,3713 Hannah Parkways,,,,,,,,,Canada,CA,ON,Toronto,Bandcamp search,bandcamp.com/app/android/search
254,1/15/20 5:23pm,Bandcamp,album,Music from Saharan WhatsApp,Etran de L'Aïr,USD,2.0,1.0,,2.0,,,,0.17,credit card,2.0,0.0,3872216238,,0.2,0.2,0.0,1.63,319.79,1.63,digital download,,http://etrandelair.bandcamp.com/album/music-from-saharan-whatsapp,,WHATSAPP-01,,,Katie Sullivan,aguilarcassandra@hotmail.com,286-665-0620x988,,Benjamin Garrett,9835 Dana Forest Apt. 589,,,,,,,,,Poland,PL,Silesia,Mysłowice,Twitter,t.co/1YMVMYCIbh?amp=1
255,1/15/20 5:25pm,Bandcamp,album,Music from Saharan WhatsApp,Etran de L'Aïr,USD,2.0,1.0,,2.0,,,,0.17,credit card,2.0,0.0,2020723609,,0.2,0.2,0.0,1.63,321.42,1.63,digital download,,http://etrandelair.bandcamp.com/album/music-from-saharan-whatsapp,,WHATSAPP-01,,,Katherine Johnson,amandawiggins@yahoo.com,502-543-7341,,Lisa Mcguire,607 Kimberly Oval,,,,,,,,,United Kingdom,GB,Devon,Exeter,Publish notice sent to your fans,
256,1/15/20 5:30pm,Bandcamp,album,Music from Saharan WhatsApp,Etran de L'Aïr,USD,10.0,1.0,,10.0,,,,0.52,credit card,10.0,0.0,2275596613,,1.0,1.0,0.0,8.48,329.9,8.48,digital download,,http://etrandelair.bandcamp.com/album/music-from-saharan-whatsapp,,WHATSAPP-01,,,Stephanie King,angel18@campbell.com,+1-312-385-3974,This is so good!,Danielle Mitchell,25362 Stephanie Stravenue Apt. 035,,,,,,,,,United States,US,MN,Saint Paul,Bandcamp fan wishlist,bandcamp.com/craigruhland
257,1/15/20 5:30pm,Bandcamp,album,Music from Saharan WhatsApp,Etran de L'Aïr,USD,1.0,1.0,,1.0,,,,0.1,paypal,1.0,0.0,2752740267,,0.1,0.1,0.0,0.8,330.7,0.8,digital download,,http://etrandelair.bandcamp.com/album/music-from-saharan-whatsapp,,WHATSAPP-01,,,Nicholas Graves,dwayne13@gmail.com,845.145.3781x931,,Brian Herrera,0959 Christine Ridge,,,,,,,,,United States,US,WI,Madison,Facebook,www.facebook.com
258,1/15/20 5:30pm,Bandcamp,album,Music from Saharan WhatsApp,Etran de L'Aïr,USD,1.0,1.0,,1.0,,,,0.1,paypal,1.0,0.0,394621835,,0.1,0.1,0.0,0.8,331.5,0.8,digital download,,http://etrandelair.bandcamp.com/album/music-from-saharan-whatsapp,,WHATSAPP-01,,,Philip Villa,zacharygordon@hotmail.com,304.714.7154,,William Bailey,211 Peter Trace Apt. 210,,,,,,,,,United States,US,OR,Portland,Google search,www.google.com/
259,1/15/20 5:30pm,Bandcamp,album,Tenere,Afous d'Afous,USD,7.0,1.0,,7.0,1.4,,,0.57,credit card,8.4,0.0,2502797519,,0.7,0.7,0.0,5.73,337.23,5.73,digital download,,http://afousdafous.bandcamp.com/album/tenere,,SS-042,191515 490421,,Katherine Johnson,aliciadiaz@gmail.com,+1-445-739-9709x11321,,Katherine Jones,3994 Warren Knolls,,,,,,,,,United Kingdom,GB,Devon,Exeter,,
260,1/15/20 5:31pm,Bandcamp,album,Music from Saharan WhatsApp,Etran de L'Aïr,USD,5.0,1.0,,5.0,,,,0.3,credit card,5.0,0.0,3704841684,,0.5,0.5,0.0,4.2,341.43,4.2,digital download,,http://etrandelair.bandcamp.com/album/music-from-saharan-whatsapp,,WHATSAPP-01,,,Craig Mann,ortizalan@garrett.biz,001-078-019-8927x9972,,Jessica Simpson,9446 Edwin Terrace Suite 988,,,,,,,,,United States,US,OH,Columbus,,
261,1/15/20 5:32pm,Bandcamp,album,Music from Saharan WhatsApp,Etran de L'Aïr,USD,3.0,1.0,,3.0,,,,0.2,credit card,3.0,0.0,1073827751,,0.3,0.3,0.0,2.5,343.93,2.5,digital download,,http://etrandelair.bandcamp.com/album/music-from-saharan-whatsapp,,WHATSAPP-01,,,Erik Bennett,mcconnelljoshua@hotmail.com,563.344.2424,,Donna Watson,33372 Bautista Summit,,,,,,,,,United States,US,NY,Brooklyn,,
262,1/15/20 5:32pm,Bandcamp,album,Sahel Sounds Label Sampler,Various Artists,USD,1.0,1.0,,1.0,,,,0.1,paypal,1.0,0.0,45830265,,0.1,0.1,0.0,0.8,344.73,0.8,digital download,,http://sahelsounds.bandcamp.com/album/sahel-sounds-label-sampler,,SS-058,602318 137111,,Daniel Stevenson,curtis80@gmail.com,239.613.8124,,Tracy Smith,45950 Peterson Extension Suite 774,,,,,,,,,United States,US,NY,Astoria,Twitter,t.co/d6EMnvx1XL?amp=1
263,1/15/20 5:35pm,Bandcamp,album,Music from Saharan WhatsApp,Etran de L'Aïr,USD,6.0,1.0,,6.0,,,,0.35,paypal,6.0,0.0,40066292,,0.6,0.6,0.0,5.05,349.78,5.05,digital download,,http://etrandelair.bandcamp.com/album/music-from-saharan-whatsapp,,WHATSAPP-01,,,Joel Krueger,john88@carter-hall.org,386.503.9152,,Rachel Hurley,721 Andrew Points,,,,,,,,,United States,US,WA,Seattle,Bandcamp search,bandcamp.com/autocomplete-search
264,1/15/20 5:35pm,Bandcamp,album,Music from Saharan WhatsApp,Etran de L'Aïr,USD,3.0,1.0,,3.0,,,,0.23,paypal,3.0,0.0,3510520435,,0.3,0.3,0.0,2.47,352.25,2.47,digital download,,http://etrandelair.bandcamp.com/album/music-from-saharan-whatsapp,,WHATSAPP-01,,,Christopher Porter,melissamiller@hotmail.com,8665238876,,Shannon Griffin,935 King Mountain Suite 615,,,,,,,,,Canada,CA,BC,Vancouver,,
265,1/15/20 5:37pm,Bandcamp,album,Music from Saharan WhatsApp,Etran de L'Aïr,USD,2.0,1.0,,2.0,,,,0.17,paypal,2.0,0.0,710900,,0.2,0.2,0.0,1.63,353.88,1.63,digital download,,http://etrandelair.bandcamp.com/album/music-from-saharan-whatsapp,,WHATSAPP-01,,,Barbara Hess,cantueugene@hotmail.com,374.280.0415,,Megan Ross,28581 Branch Walks Apt. 573,,,,,,,,,United Kingdom,GB,Bromley,Bromley,,
266,1/15/20 5:39pm,Bandcamp,album,Music from Saharan WhatsApp,Etran de L'Aïr,USD,3.0,1.0,,3.0,,,,0.2,paypal,3.0,0.0,392618175,,0.3,0.3,0.0,2.5,356.38,2.5,digital download,,http://etrandelair.bandcamp.com/album/music-from-saharan-whatsapp,,WHATSAPP-01,,,Alexandra Johnson,stephaniescott@galloway.com,+1-261-286-7914x28811,,Crystal Barrett,823 Bradley Cliff Suite 141,,,,,,,,,United States,US,DC,Washington,Facebook,www.facebook.com
267,1/15/20 5:49pm,Bandcamp,album,Music from Saharan WhatsApp,Etran de L'Aïr,USD,8.0,1.0,,8.0,,,,0.53,paypal,8.0,0.0,3221976073,,0.8,0.8,0.0,6.67,363.05,6.67,digital download,,http://etrandelair.bandcamp.com/album/music-from-saharan-whatsapp,,WHATSAPP-01,,,Caroline Marquez,allison03@stephens.biz,2543865930,,Julie Dunn,08051 Mitchell Place Apt. 990,,,,,,,,,Ireland,IE,Leinster,Dublin,,
268,1/15/20 5:51pm,Bandcamp,album,Music from Saharan WhatsApp,Etran de L'Aïr,USD,10.0,1.0,,10.0,,,,0.59,paypal,10.0,0.0,2701668002,,1.0,1.0,0.0,8.41,371.46,8.41,digital download,,http://etrandelair.bandcamp.com/album/music-from-saharan-whatsapp,,WHATSAPP-01,,,Michael Owen,nelsoncynthia@yahoo.com,356-257-7516x38717,,Joseph Moore,0765 Walters Spurs Apt. 549,,,,,,,,,Poland,PL,Pomerania,Gdynia,,
269,1/15/20 5:53pm,Bandcamp,album,Music from Saharan WhatsApp,Etran de L'Aïr,USD,10.0,1.0,,10.0,,,,0.49,paypal,10.0,0.0,1024901125,,1.0,1.0,0.0,8.51,379.97,8.51,digital download,,http://etrandelair.bandcamp.com/album/music-from-saharan-whatsapp,,WHATSAPP-01,,,James Walker,spowell@hotmail.com,(704)194-8280x87399,,Brian Bonilla,933 Michelle Islands Suite 411,,,,,,,,,United States,US,CA,Mission Viejo,Publish notice sent to your fans,
270,1/15/20 5:56pm,Bandcamp,album,Music from Saharan WhatsApp,Etran de L'Aïr,USD,3.0,1.0,,3.0,,,,0.2,credit card,3.0,0.0,99103427,,0.3,0.3,0.0,2.5,382.47,2.5,digital download,,http://etrandelair.bandcamp.com/album/music-from-saharan-whatsapp,,WHATSAPP-01,,,Linda Holloway,thompsonjonathan@smith.info,001-517-005-5294,,Matthew Gomez,70964 Ramos Terrace Apt. 213,,,,,,,,,United States,US,TX,Dallas,,
271,1/15/20 5:56pm,Bandcamp,album,Music from Saharan WhatsApp,Etran de L'Aïr,USD,5.0,1.0,,5.0,,,,0.3,paypal,5.0,0.0,1017859465,,0.5,0.5,0.0,4.2,386.67,4.2,digital download,,http://etrandelair.bandcamp.com/album/music-from-saharan-whatsapp,,WHATSAPP-01,,,Katie Buck,garyferrell@smith.org,(915)246-0191,,Sarah Cooper,6942 Caldwell Club Suite 840,,,,,,,,,United States,US,TN,Brentwood,Google search,www.google.com/
272,1/15/20 5:59pm,Bandcamp,album,Sahel Sounds Label Sampler,Various Artists,USD,1.0,1.0,,1.0,,,,0.11,credit card,1.0,0.0,509333082,,0.1,0.1,0.0,0.79,387.46,0.79,digital download,,http://sahelsounds.bandcamp.com/album/sahel-sounds-label-sampler,,SS-058,602318 137111,,Katie Sullivan,gscott@gmail.com,910-206-8405,,Brittany Rodgers,898 Hancock Grove,,,,,,,,,Poland,PL,Silesia,Mysłowice,Twitter,t.co/d6EMnvx1XL?amp=1
273,1/15/20 6:02pm,shop@sahelsounds.com,payout,,,USD,,,,,,,,1.31,transfer,131.11,129.8,t251441467,81176300ES8043226,,,,-131.11,256.35,,,,,,,,,,,,,,,,,,,,,,,,,,,,
274,1/15/20 6:02pm,shop@sahelsounds.com,payout,,,USD,,,,,,,,0.12,transfer,11.73,11.61,t251441464,80R32594DN142772H,,,,-11.73,244.62,,,,,,,,,,,,,,,,,,,,,,,,,,,,
275,1/15/20 6:05pm,Bandcamp,album,Music from Saharan WhatsApp,Etran de L'Aïr,USD,8.0,1.0,,8.0,,,,0.45,paypal,8.0,0.0,3261064388,,0.8,0.8,0.0,6.75,251.37,6.75,digital download,,http://etrandelair.bandcamp.com/album/music-from-saharan-whatsapp,,WHATSAPP-01,,,Aaron Ortega,helenwebb@benjamin.com,(180)107-6579,,Ryan Garcia,76483 Meyer Ville Suite 254,,,,,,,,,United States,US,,,Publish notice sent to your fans,
276,1/15/20 6:10pm,Bandcamp,album,Music from Saharan WhatsApp,Etran de L'Aïr,USD,5.0,1.0,,5.0,,,,0.35,paypal,5.0,0.0,2911485467,,0.5,0.5,0.0,4.15,255.52,4.15,digital download,,http://etrandelair.bandcamp.com/album/music-from-saharan-whatsapp,,WHATSAPP-01,,,Vanessa Donovan,turnerjoseph@ortiz-rodgers.info,001-314-501-7089x12962,,Carolyn Wallace,50747 Tammy Keys,,,,,,,,,United Kingdom,GB,Manchester,Manchester,,
277,1/15/20 6:12pm,Bandcamp,album,Ilana: The Creator,Mdou Moctar,USD,8.0,1.0,,8.0,,,,0.45,paypal,8.0,0.0,2365781893,,0.8,0.8,0.0,6.75,262.27,6.75,digital download,,http://mdoumoctar.bandcamp.com/album/ilana-the-creator,,SS-051,602318 136893,,Aaron Ortega,joel19@gmail.com,001-041-420-5416x2290,,Vanessa Jordan,64299 Petersen Parkway Suite 950,,,,,,,,,United States,US,,,,
278,1/15/20 6:15pm,Bandcamp,album,Music from Saharan WhatsApp,Etran de L'Aïr,USD,1.0,1.0,,1.0,,,,0.11,paypal,1.0,0.0,1428037103,,0.1,0.1,0.0,0.79,263.06,0.79,digital download,,http://etrandelair.bandcamp.com/album/music-from-saharan-whatsapp,,WHATSAPP-01,,,Robert Woods,rileybrian@adams.net,777.994.7600x058,,Mario Baker,2132 Vincent Motorway,,,,,,,,,United Kingdom,GB,Haringey,Wood Green,,
279,1/15/20 6:16pm,Bandcamp,album,Music from Saharan WhatsApp,Etran de L'Aïr,USD,3.0,1.0,,3.0,,,,0.23,credit card,3.0,0.0,4241601054,,0.3,0.3,0.0,2.47,265.53,2.47,digital download,,http://etrandelair.bandcamp.com/album/music-from-saharan-whatsapp,,WHATSAPP-01,,,Maria Thomas,jennifer15@gmail.com,695.904.9820x29914,,Antonio Price,492 Obrien Corner,,,,,,,,,United Kingdom,GB,Gloucestershire,Cheltenham,Bandcamp music feed: Chimplesticks - jedwardkeyes,http://blog.bandcamp.com/2013/09/19/strap-on-your-feed-bag/
280,1/15/20 6:17pm,Bandcamp,album,Music from Saharan WhatsApp,Etran de L'Aïr,USD,3.0,1.0,,3.0,,,,0.2,paypal,3.0,0.0,3549060582,,0.3,0.3,0.0,2.5,268.03,2.5,digital download,,http://etrandelair.bandcamp.com/album/music-from-saharan-whatsapp,,WHATSAPP-01,,,Adrian Turner,patricialopez@grant.com,+1-172-618-5175,,Lori Young,60323 Bernard Views,,,,,,,,,United States,US,MO,Columbia,,
281,1/15/20 6:20pm,Bandcamp,album,Music from Saharan WhatsApp,Etran de L'Aïr,USD,3.0,1.0,,3.0,,,,0.11,credit card,3.0,0.0,4222968652,,0.3,0.3,0.0,2.59,270.62,2.59,digital download,,http://etrandelair.bandcamp.com/album/music-from-saharan-whatsapp,,WHATSAPP-01,,,Peter Peterson,patriciazhang@hotmail.com,(962)253-5514x52798,,Christina Walker,8712 Scott Tunnel,,,,,,,,,United States,US,CA,Los Angeles,Bandcamp search,bandcamp.com/autocomplete-search
282,1/15/20 6:23pm,Bandcamp,album,Music from Saharan WhatsApp,Etran de L'Aïr,USD,5.0,1.0,,5.0,,,,0.3,credit card,5.0,0.0,4082042751,,0.5,0.5,0.0,4.2,274.82,4.2,digital download,,http://etrandelair.bandcamp.com/album/music-from-saharan-whatsapp,,WHATSAPP-01,,,Natalie Owens,jamesstewart@gmail.com,001-743-492-3520x0437,,Stephen Fleming,68052 Owens Mall Suite 135,,,,,,,,,United States,US,CA,Marina del Rey,,
283,1/15/20 6:25pm,Bandcamp,album,Music from Saharan WhatsApp,Etran de L'Aïr,USD,3.0,1.0,,3.0,,,,0.2,credit card,3.0,0.0,2369112796,,0.3,0.3,0.0,2.5,277.32,2.5,digital download,,http://etrandelair.bandcamp.com/album/music-from-saharan-whatsapp,,WHATSAPP-01,,,Stacey Scott,schan@hotmail.com,4550080454,,Vanessa West,4042 Newman View Suite 012,,,,,,,,,United States,US,CA,Goleta,,
284,1/15/20 6:30pm,Bandcamp,album,Music from Saharan WhatsApp,Etran de L'Aïr,USD,1.0,1.0,,1.0,,,,0.11,paypal,1.0,0.0,3288525994,,0.1,0.1,0.0,0.79,278.11,0.79,digital download,,http://etrandelair.bandcamp.com/album/music-from-saharan-whatsapp,,WHATSAPP-01,,,Christopher Decker,robertyoung@hotmail.com,+1-046-196-5754x37300,,Richard Mejia,2592 Hughes Cove Apt. 869,,,,,,,,,Canada,CA,BC,Vancouver,Publish notice sent to your fans,
285,1/15/20 6:31pm,Bandcamp,album,Music from Saharan WhatsApp,Etran de L'Aïr,USD,5.0,1.0,,5.0,,,,0.3,paypal,5.0,0.0,427812883,,0.5,0.5,0.0,4.2,282.31,4.2,digital download,,http://etrandelair.bandcamp.com/album/music-from-saharan-whatsapp,,WHATSAPP-01,,,Kevin Robinson,patriciamendoza@guzman.com,(727)046-8019,,Omar Gonzalez,93321 Rollins Coves,,,,,,,,,United States,US,AL,Tuscaloosa,,
286,1/15/20 6:37pm,Bandcamp,album,Music from Saharan WhatsApp,Etran de L'Aïr,USD,5.0,1.0,,5.0,,,,0.3,paypal,5.0,0.0,495021994,,0.5,0.5,0.0,4.2,286.51,4.2,digital download,,http://etrandelair.bandcamp.com/album/music-from-saharan-whatsapp,,WHATSAPP-01,,,Kathleen Bonilla,ramirezalyssa@schultz-dennis.net,071.848.3885,,Maria Soto,280 Caleb Bridge Apt. 458,,,,,,,,,United States,US,NY,Brooklyn,Facebook,www.facebook.com
287,1/15/20 6:42pm,Bandcamp,album,Music from Saharan WhatsApp,Etran de L'Aïr,USD,1.0,1.0,,1.0,,,,0.11,paypal,1.0,0.0,2872047039,,0.1,0.1,0.0,0.79,287.3,0.79,digital download,,http://etrandelair.bandcamp.com/album/music-from-saharan-whatsapp,,WHATSAPP-01,,,Damon Nicholson,wendy33@gmail.com,3253115323,,Jennifer Carter,4891 Rebecca Junctions Suite 635,,,,,,,,,France,FR,Maine-et-Loire,Angers,,
288,1/15/20 6:43pm,Bandcamp,album,Music from Saharan WhatsApp,Etran de L'Aïr,USD,1.0,1.0,,1.0,,,,0.11,paypal,1.0,0.0,1008422280,,0.1,0.1,0.0,0.79,288.09,0.79,digital download,,http://etrandelair.bandcamp.com/album/music-from-saharan-whatsapp,,WHATSAPP-01,,,Jason Howard,josephmorris@simmons-roy.com,6165757898,,Edward Willis,180 Joseph Land,,,,,,,,,United Kingdom,GB,,,,
289,1/15/20 6:47pm,Bandcamp,package,No. 1,Etran de L'Aïr,USD,17.0,1.0,,17.0,,5.0,United States,0.72,paypal,22.0,0.0,3549675138,,1.7,1.7,0.0,19.58,307.67,14.58,Limited Edition LP,,http://etrandelair.bandcamp.com/album/no-1,SS-045lp,SS-045,602318 136824,,Christine Knight,scottdodson@simmons-tate.com,487-299-0532x954,,Derek Reeves,125 Robert View Apt. 109,,Lakewood,OH,44107,United States,US,1/21/20,,United States,US,OH,Lakewood,,
290,1/15/20 6:48pm,Bandcamp,album,Music from Saharan WhatsApp,Etran de L'Aïr,USD,10.0,1.0,,10.0,,,,0.49,paypal,10.0,0.0,2756555998,,1.0,1.0,0.0,8.51,316.18,8.51,digital download,,http://etrandelair.bandcamp.com/album/music-from-saharan-whatsapp,,WHATSAPP-01,,,Thomas Duarte,joseli@shields-cooper.com,+1-840-581-3794,,Julie Nunez,3474 Dominique Meadow,,,,,,,,,United States,US,NY,New York,,
291,1/15/20 6:49pm,Bandcamp,album,Music from Saharan WhatsApp,Etran de L'Aïr,USD,3.0,1.0,,3.0,,,,0.23,paypal,3.0,0.0,249789018,,0.3,0.3,0.0,2.47,318.65,2.47,digital download,,http://etrandelair.bandcamp.com/album/music-from-saharan-whatsapp,,WHATSAPP-01,,,Laura Black,stephenevans@gmail.com,128-926-3814,,Dwayne Burns,008 Erickson Curve Suite 773,,,,,,,,,United Kingdom,GB,Hackney,Stoke Newington,,
292,1/15/20 6:56pm,Bandcamp,album,Tiris,El Wali,USD,7.0,1.0,,7.0,,,,0.4,credit card,7.0,0.0,3611254091,,0.7,0.7,0.0,5.9,324.55,5.9,digital download,,http://elwali.bandcamp.com/album/tiris,,SS-055,602318 136923,,Elizabeth Ray,crussell@hotmail.com,630.202.2077x0819,,Cameron George,6961 Russell Lakes Suite 848,,,,,,,,,United States,US,NY,Brooklyn,,
293,1/15/20 6:56pm,Bandcamp,album,Music from Saharan WhatsApp,Etran de L'Aïr,USD,2.0,1.0,,2.0,,,,0.17,credit card,2.0,0.0,3027623453,,0.2,0.2,0.0,1.63,326.18,1.63,digital download,,http://etrandelair.bandcamp.com/album/music-from-saharan-whatsapp,,WHATSAPP-01,,,James Williams,antonio23@garcia-martin.com,(371)508-5384x209,,James Paul,6956 Clarke Tunnel Suite 651,,,,,,,,,Italy,IT,Provincia di Latina,Latina,,
294,1/15/20 6:59pm,Bandcamp,album,Music from Saharan WhatsApp,Etran de L'Aïr,USD,1.0,1.0,,1.0,,,,0.1,credit card,1.0,0.0,4128322221,,0.1,0.1,0.0,0.8,326.98,0.8,digital download,,http://etrandelair.bandcamp.com/album/music-from-saharan-whatsapp,,WHATSAPP-01,,,Dominic Hodge,gregory32@yahoo.com,+1-670-817-7593x471,,Caitlin Chandler,8928 Brandon Ville Suite 873,,,,,,,,,United States,US,IL,Chicago,,
295,1/15/20 7:06pm,Bandcamp,album,Music from Saharan WhatsApp,Etran de L'Aïr,USD,1.0,1.0,,1.0,,,,0.11,paypal,1.0,0.0,3853811958,,0.1,0.1,0.0,0.79,327.77,0.79,digital download,,http://etrandelair.bandcamp.com/album/music-from-saharan-whatsapp,,WHATSAPP-01,,,Christine Morales,pmorrison@yahoo.com,(985)225-1992x4222,,Austin Alexander,24391 Deborah Branch,,,,,,,,,Netherlands,NL,North Holland,Krommenie,Facebook,www.facebook.com
296,1/15/20 7:12pm,Bandcamp,album,Music from Saharan WhatsApp,Etran de L'Aïr,USD,5.0,1.0,,5.0,,,,0.3,paypal,5.0,0.0,1191865532,,0.5,0.5,0.0,4.2,331.97,4.2,digital download,,http://etrandelair.bandcamp.com/album/music-from-saharan-whatsapp,,WHATSAPP-01,,,Jeremiah Rodriguez,christopher81@daniels-liu.org,(754)592-3915x09155,,Joan Chandler,4567 Hernandez Creek Apt. 775,,,,,,,,,United States,US,CA,Los Angeles,,
297,1/15/20 7:17pm,Bandcamp,album,Music from Saharan WhatsApp,Etran de L'Aïr,USD,3.0,1.0,,3.0,,,,0.2,credit card,3.0,0.0,1131236841,,0.3,0.3,0.0,2.5,334.47,2.5,digital download,,http://etrandelair.bandcamp.com/album/music-from-saharan-whatsapp,,WHATSAPP-01,,,Johnny Mccarty,jordandouglas@yahoo.com,001-354-080-8184x98020,,Christina Ramirez,2712 Collins Isle,,,,,,,,,United States,US,CA,El Cerrito,Bandcamp New & Notable,bandcamp.com/#new-notable
298,1/15/20 7:17pm,Bandcamp,package,Ilana: The Creator,Mdou Moctar,USD,18.0,1.0,,18.0,,5.0,United States,0.81,credit card,23.0,0.0,482034292,,1.8,1.8,0.0,20.39,354.86,15.39,Ilana LP,,http://mdoumoctar.bandcamp.com/album/ilana-the-creator,SS-051lp,SS-051,602318 136893,,Warren Velez,mchung@gmail.com,5784941560,,Donna Gonzales,166 Mathis Island,,Avondale,AZ,85392,United States,US,1/21/20,,United States,US,AZ,Avondale,,
299,1/15/20 7:20pm,Bandcamp,album,Music from Saharan WhatsApp,Etran de L'Aïr,USD,3.0,1.0,,3.0,,,,0.2,credit card,3.0,0.0,3414446130,,0.3,0.3,0.0,2.5,357.36,2.5,digital download,,http://etrandelair.bandcamp.com/album/music-from-saharan-whatsapp,,WHATSAPP-01,,,Karen Parks,vroberts@gmail.com,+1-797-243-7049x2439,,Clayton Reyes,739 White Run,,,,,,,,,United States,US,CA,Los Angeles,,
300,1/15/20 7:24pm,Bandcamp,album,Music from Saharan WhatsApp,Etran de L'Aïr,USD,3.0,1.0,,3.0,,,,0.2,paypal,3.0,0.0,2043146724,,0.3,0.3,0.0,2.5,359.86,2.5,digital download,,http://etrandelair.bandcamp.com/album/music-from-saharan-whatsapp,,WHATSAPP-01,,,Dakota Cunningham,aprilvaldez@yahoo.com,(528)763-1198x90281,,Crystal Wright,529 Hannah Lights Suite 792,,,,,,,,,United States,US,CA,Los Angeles,Publish notice sent to your fans,
301,1/15/20 7:34pm,Bandcamp,album,Music from Saharan WhatsApp,Etran de L'Aïr,USD,5.0,1.0,,5.0,,,,0.35,paypal,5.0,0.0,394354784,,0.5,0.5,0.0,4.15,364.01,4.15,digital download,,http://etrandelair.bandcamp.com/album/music-from-saharan-whatsapp,,WHATSAPP-01,,,Paul Barrett,wwilliams@baker.biz,718.244.2888x041,,Luke Lowe,098 Johnson Cliff Apt. 632,,,,,,,,,United Kingdom,GB,Somerset,Bruton,Bandcamp artist: etrandelair,etrandelair.bandcamp.com/album/music-from-saharan-whatsapp
302,1/15/20 7:39pm,Bandcamp,album,Music from Saharan WhatsApp,Etran de L'Aïr,USD,5.0,1.0,,5.0,,,,0.3,paypal,5.0,0.0,4001345932,,0.5,0.5,0.0,4.2,368.21,4.2,digital download,,http://etrandelair.bandcamp.com/album/music-from-saharan-whatsapp,,WHATSAPP-01,,,Mikayla Thomas,catherinemacias@hotmail.com,723.680.3276x18087,,Monique Matthews,473 Robert Causeway Suite 827,,,,,,,,,United States,US,CA,Berkeley,,
303,1/15/20 8:05pm,Bandcamp,package,Tiris,El Wali,USD,17.0,1.0,,17.0,,5.0,United States,0.78,credit card,22.0,0.0,3341098989,,1.7,1.7,0.0,19.52,387.73,14.52,Tiris LP,,http://elwali.bandcamp.com/album/tiris,SS-055lp,SS-055,602318 136923,,Alyssa Spencer,jonesamanda@gmail.com,037.101.5522,,Phillip Young,055 Robert Ford Apt. 990,,Draper,UT,84020,United States,US,1/21/20,,United States,US,UT,Draper,Bandcamp search,bandcamp.com/autocomplete-search
304,1/15/20 8:10pm,Bandcamp,album,Music from Saharan WhatsApp,Etran de L'Aïr,USD,5.0,1.0,,5.0,,,,0.35,paypal,5.0,0.0,86148314,,0.5,0.5,0.0,4.15,391.88,4.15,digital download,,http://etrandelair.bandcamp.com/album/music-from-saharan-whatsapp,,WHATSAPP-01,,,Timothy Evans,ireed@yahoo.com,001-369-546-3427x15964,,Eric Myers,3831 Peterson Fort Suite 550,,,,,,,,,Sweden,SE,Värmland,Karlstad,Publish notice sent to your fans,
305,1/15/20 8:33pm,Bandcamp,album,Music from Saharan WhatsApp,Etran de L'Aïr,USD,5.0,1.0,,5.0,,,,0.3,paypal,5.0,0.0,1272655266,,0.5,0.5,0.0,4.2,396.08,4.2,digital download,,http://etrandelair.bandcamp.com/album/music-from-saharan-whatsapp,,WHATSAPP-01,,,Tyrone Cervantes,heidicortez@yahoo.com,7581759993,,Johnathan Mccann,06720 Baker Stream,,,,,,,,,United States,US,CA,Santa Monica,,
306,1/15/20 8:33pm,Bandcamp,album,Music from Saharan WhatsApp,Etran de L'Aïr,USD,4.0,1.0,,4.0,,,,0.25,paypal,4.0,0.0,1720399426,,0.4,0.4,0.0,3.35,399.43,3.35,digital download,,http://etrandelair.bandcamp.com/album/music-from-saharan-whatsapp,,WHATSAPP-01,,,Maria Blankenship,ujones@henderson.com,141-758-4935,,Leslie Jones,75799 Mcintyre Wall,,,,,,,,,United States,US,NY,New York,Publish notice sent to your fans,
307,1/15/20 8:39pm,Bandcamp,album,Music from Saharan Cellphones,Various,USD,9.0,1.0,,9.0,1.33,,,0.6,paypal,10.33,0.0,1813268026,,0.9,0.9,0.0,7.5,406.93,7.5,digital download,,http://sahelsounds.bandcamp.com/album/music-from-saharan-cellphones,,SS-003,889326 667889,,Chelsea Flynn,linda69@garcia.com,914.747.0155,,Charles Trevino,17356 Sullivan Junction,,,,,,,,,Germany,DE,Rheinland-Pfalz,Mainz,Bandcamp fan wishlist,bandcamp.com/secondgoddess
308,1/15/20 8:40pm,Bandcamp,album,Music from Saharan WhatsApp,Etran de L'Aïr,USD,10.0,1.0,,10.0,,,,0.49,paypal,10.0,0.0,63533425,,1.0,1.0,0.0,8.51,415.44,8.51,digital download,,http://etrandelair.bandcamp.com/album/music-from-saharan-whatsapp,,WHATSAPP-01,,,Kevin Pittman,zcole@hotmail.com,+1-958-886-7880,,Mary Wheeler,5197 Mary Stream,,,,,,,,,United States,US,CO,Denver,Publish notice sent to your fans,
309,1/15/20 8:48pm,Bandcamp,album,Music from Saharan WhatsApp,Etran de L'Aïr,USD,10.0,1.0,,10.0,,,,0.59,paypal,10.0,0.0,638423448,,1.0,1.0,0.0,8.41,423.85,8.41,digital download,,http://etrandelair.bandcamp.com/album/music-from-saharan-whatsapp,,WHATSAPP-01,,,Jacob Mendez,ifitzgerald@carter.biz,+1-995-888-3293x255,,Dylan Roach,49444 Hernandez Rue,,,,,,,,,United States,US,AZ,Phoenix,,
310,1/15/20 8:49pm,Bandcamp,album,Music from Saharan WhatsApp,Etran de L'Aïr,USD,2.0,1.0,,2.0,,,,0.17,paypal,2.0,0.0,2641909628,,0.2,0.2,0.0,1.63,425.48,1.63,digital download,,http://etrandelair.bandcamp.com/album/music-from-saharan-whatsapp,,WHATSAPP-01,,,Ashley Padilla,rodriguezbrittany@gmail.com,796.856.3109x464,,James Williams,1198 Oscar Radial,,,,,,,,,Qatar,QA,Baladiyat ad Dawhah,Doha,Bandcamp New & Notable,bandcamp.com/#new-notable
311,1/15/20 8:52pm,Bandcamp,album,Music from Saharan WhatsApp,Etran de L'Aïr,USD,3.0,1.0,,3.0,,,,0.2,credit card,3.0,0.0,375733602,,0.3,0.3,0.0,2.5,427.98,2.5,digital download,,http://etrandelair.bandcamp.com/album/music-from-saharan-whatsapp,,WHATSAPP-01,,,Andrew Brown,meghanpierce@hotmail.com,972-288-6416,,Jennifer Peters,2619 Knox Inlet Apt. 097,,,,,,,,,United States,US,CA,Glendale,Publish notice sent to your fans,
312,1/15/20 9:09pm,Bandcamp,album,Music from Saharan WhatsApp,Etran de L'Aïr,USD,5.0,1.0,,5.0,,,,0.3,paypal,5.0,0.0,3886783859,,0.5,0.5,0.0,4.2,432.18,4.2,digital download,,http://etrandelair.bandcamp.com/album/music-from-saharan-whatsapp,,WHATSAPP-01,,,Deborah Thomas,rhonda13@evans-flores.com,001-799-640-6236x0589,,Jose Hicks,8950 Robert Shores,,,,,,,,,United States,US,CA,San Francisco,Bandcamp New & Notable,bandcamp.com/#new-notable
313,1/15/20 9:22pm,Bandcamp,album,Ilana: The Creator,Mdou Moctar,USD,9.0,1.0,,9.0,,,,0.64,paypal,9.0,0.0,758456613,,0.9,0.0,0.9,0.0,432.18,7.46,digital download,,http://mdoumoctar.bandcamp.com/album/ilana-the-creator,,SS-051,602318 136893,,Glen Rangel,qwebb@jackson.org,001-043-176-0992,,Darren Myers,59846 Andrew Centers Apt. 496,,,,,,,,,United States,US,MT,Bozeman,Recommendations footer: commonly collected,bandcamp.com/footer/cc/a3785769451
314,1/15/20 9:22pm,Bandcamp,album,Sousoume Tamachek,Mdou Moctar,USD,9.0,1.0,,9.0,,,,,,9.0,0.0,758456613,,0.9,1.8,0.0,15.56,447.74,8.1,digital download,,http://mdoumoctar.bandcamp.com/album/sousoume-tamachek,,SS-043,191515 769435,,Glen Rangel,greenanthony@proctor.com,7271849719,,Mary Gentry,7801 Black Roads Apt. 486,,,,,,,,,United States,US,MT,Bozeman,Recommendations footer: commonly collected,bandcamp.com/footer/cc/a3785769451
315,1/15/20 9:43pm,Bandcamp,album,Uchronia – Field Recordings From Alternate Realities,Sahel Sounds,USD,1.0,1.0,,1.0,,,,0.11,paypal,1.0,0.0,3191688701,,0.1,0.1,0.0,0.79,448.53,0.79,digital download,,http://sahelsounds.bandcamp.com/album/uchronia-field-recordings-from-alternate-realities,,SS-000,,,Ryan Fletcher,mirandashawn@gmail.com,923.679.4723x274,,Cynthia Summers,676 Valentine Alley,,,,,,,,,Spain,ES,Barcelona,Barcelona,Bandcamp fan wishlist,bandcamp.com/fibreglass
316,1/15/20 10:12pm,Bandcamp,album,Music from Saharan WhatsApp,Etran de L'Aïr,USD,10.0,1.0,,10.0,,,,0.59,paypal,10.0,0.0,1140722191,,1.0,1.0,0.0,8.41,456.94,8.41,digital download,,http://etrandelair.bandcamp.com/album/music-from-saharan-whatsapp,,WHATSAPP-01,,,Tammy Randall,rbrown@white.com,(136)364-3652,,Dennis Saunders,35385 Isaac Mount Apt. 094,,,,,,,,,Australia,AU,NSW,Ultimo,Publish notice sent to your fans,
317,1/15/20 10:21pm,Bandcamp,album,Eghass Malan,Les Filles de Illighadad,USD,7.0,1.0,,7.0,1.75,,,0.58,credit card,8.75,0.0,3572499131,,0.7,0.7,0.0,5.72,462.66,5.72,digital download,,http://lesfillesdeillighadad.bandcamp.com/album/eghass-malan,,SS-044,191515 928351,,Fred George,william32@meza.org,001-725-955-4445,Great music. Please come to play in Denmark! Maybe in Loppen or Alice?,Michael Perkins,26376 Alyssa Gateway,,,,,,,,,Denmark,DK,Capital Region,Copenhagen,,
318,1/15/20 10:24pm,Bandcamp,album,Music from Saharan WhatsApp,Etran de L'Aïr,USD,6.0,1.0,,6.0,,,,0.35,paypal,6.0,0.0,1178924796,,0.6,0.6,0.0,5.05,467.71,5.05,digital download,,http://etrandelair.bandcamp.com/album/music-from-saharan-whatsapp,,WHATSAPP-01,,,Mercedes Carr,emilyjohnson@flowers.com,+1-570-020-6935x0609,,Christine Stokes,314 Payne Estate Suite 887,,,,,,,,,United States,US,MN,Minneapolis,Publish notice sent to your fans,
319,1/15/20 10:25pm,Bandcamp,album,Sahel Sounds Label Sampler,Various Artists,USD,4.0,1.0,,4.0,,,,0.29,credit card,4.0,0.0,531075969,,0.4,0.4,0.0,3.31,471.02,3.31,digital download,,http://sahelsounds.bandcamp.com/album/sahel-sounds-label-sampler,,SS-058,602318 137111,,Fred George,myersvictoria@thompson.com,+1-908-653-7353x66669,,Brett Nelson,42616 Aguirre Valley Apt. 586,,,,,,,,,Denmark,DK,Capital Region,Copenhagen,bandcamp.com,bandcamp.com
320,1/15/20 10:26pm,Bandcamp,album,Music from Saharan WhatsApp,Etran de L'Aïr,USD,1.0,1.0,,1.0,,,,0.11,paypal,1.0,0.0,4110900348,,0.1,0.1,0.0,0.79,471.81,0.79,digital download,,http://etrandelair.bandcamp.com/album/music-from-saharan-whatsapp,,WHATSAPP-01,,,Matthew Jackson,alyssa36@maldonado-roberson.com,001-472-490-9085x686,,Shawn Stevens,1486 Mark Route,,,,,,,,,United Kingdom,GB,Manchester,Manchester,,
321,1/15/20 10:33pm,Bandcamp,album,Music from Saharan WhatsApp,Etran de L'Aïr,USD,6.0,1.0,,6.0,,,,0.35,credit card,6.0,0.0,1478461409,,0.6,0.6,0.0,5.05,476.86,5.05,digital download,,http://etrandelair.bandcamp.com/album/music-from-saharan-whatsapp,,WHATSAPP-01,,,Bethany Crawford,craig70@hotmail.com,4148864753,,Miranda Stevens,2735 Webb Summit,,,,,,,,,United States,US,MN,Minneapolis,Bandcamp artist: etrandelair,etrandelair.bandcamp.com
322,1/15/20 10:36pm,Bandcamp,album,Music from Saharan WhatsApp,Etran de L'Aïr,USD,4.0,1.0,,4.0,,,,0.29,credit card,4.0,0.0,1125814948,,0.4,0.4,0.0,3.31,480.17,3.31,digital download,,http://etrandelair.bandcamp.com/album/music-from-saharan-whatsapp,,WHATSAPP-01,,,Barbara Winters,zbarber@gmail.com,001-514-501-1730x245,,Joyce Brooks,586 Hernandez Center Suite 712,,,,,,,,,Canada,CA,ON,Toronto,l.instagram.com,l.instagram.com/
323,1/15/20 10:50pm,Bandcamp,album,Music from Saharan WhatsApp,Etran de L'Aïr,USD,1.0,1.0,,1.0,,,,0.1,credit card,1.0,0.0,2360480476,,0.1,0.1,0.0,0.8,480.97,0.8,digital download,,http://etrandelair.bandcamp.com/album/music-from-saharan-whatsapp,,WHATSAPP-01,,,Donna Miller,gonzalesmeagan@ware-osborne.com,(946)448-9382,,Kara Miller,9950 Walker Unions Suite 472,,,,,,,,,United States,US,CA,San Lorenzo,Bandcamp music feed: functime - jedwardkeyes,http://blog.bandcamp.com/2013/09/19/strap-on-your-feed-bag/
324,1/15/20 10:52pm,Bandcamp,album,Music from Saharan WhatsApp,Etran de L'Aïr,USD,1.0,1.0,,1.0,,,,0.11,credit card,1.0,0.0,4099934331,,0.1,0.1,0.0,0.79,481.76,0.79,digital download,,http://etrandelair.bandcamp.com/album/music-from-saharan-whatsapp,,WHATSAPP-01,,,Eric Ellis,asantos@reed-aguilar.com,995.068.6939x548,,Lisa Stevens,788 Melinda Viaduct,,,,,,,,,New Zealand,NZ,Auckland,Auckland,,
325,1/15/20 11:03pm,Bandcamp,album,Music from Saharan WhatsApp,Etran de L'Aïr,USD,3.0,1.0,,3.0,,,,0.23,paypal,3.0,0.0,711778317,,0.3,0.3,0.0,2.47,484.23,2.47,digital download,,http://etrandelair.bandcamp.com/album/music-from-saharan-whatsapp,,WHATSAPP-01,,,John Perez,angelabrown@ewing.info,138.362.6515x18013,,Kim Fischer,997 Jack Summit,,,,,,,,,United Kingdom,GB,Angus,Montrose,,
326,1/15/20 11:04pm,Bandcamp,album,Music from Saharan WhatsApp,Etran de L'Aïr,USD,2.0,1.0,,2.0,,,,0.17,paypal,2.0,0.0,3871187738,,0.2,0.2,0.0,1.63,485.86,1.63,digital download,,http://etrandelair.bandcamp.com/album/music-from-saharan-whatsapp,,WHATSAPP-01,,,Thomas Smith,nicholashall@vargas.biz,(904)036-7567x719,,Kim Williams,2542 Morris Pines,,,,,,,,,Australia,AU,NSW,Wollongong,Facebook,m.facebook.com
327,1/15/20 11:07pm,Bandcamp,album,Music from Saharan WhatsApp,Etran de L'Aïr,USD,5.0,1.0,,5.0,,,,0.35,paypal,5.0,0.0,1384616841,,0.5,0.5,0.0,4.15,490.01,4.15,digital download,,http://etrandelair.bandcamp.com/album/music-from-saharan-whatsapp,,WHATSAPP-01,,,Michelle Fuller,melissayu@miller.com,001-511-237-6577x0836,,Kaitlyn Mendoza,3447 Matthews Stream,,,,,,,,,United Kingdom,GB,Cornwall,Ponsanooth,Bandcamp music feed,http://blog.bandcamp.com/2014/01/30/bandcamp-app-now-with-music-feed/
328,1/15/20 11:30pm,Bandcamp,album,Music from Saharan WhatsApp,Etran de L'Aïr,USD,7.0,1.0,,7.0,,,,0.4,paypal,7.0,0.0,3363674633,,0.7,0.7,0.0,5.9,495.91,5.9,digital download,,http://etrandelair.bandcamp.com/album/music-from-saharan-whatsapp,,WHATSAPP-01,,,Patricia Dougherty,daniel18@morris-young.com,(391)647-3666,,Heather Munoz,373 Morales Green,,,,,,,,,United States,US,OR,Portland,,
329,1/15/20 11:34pm,Bandcamp,album,Music from Saharan WhatsApp,Etran de L'Aïr,USD,3.0,1.0,,3.0,,,,0.2,paypal,3.0,0.0,3623872237,,0.3,0.3,0.0,2.5,498.41,2.5,digital download,,http://etrandelair.bandcamp.com/album/music-from-saharan-whatsapp,,WHATSAPP-01,,,Keith Flores,pettyjoe@mcgee.com,+1-636-255-9559x5470,,Andrew Haas,0837 Campbell Trail Suite 254,,,,,,,,,United States,US,NY,Brooklyn,Bandcamp fan wishlist,bandcamp.com/madsen
330,1/15/20 11:37pm,Bandcamp,album,Music from Saharan WhatsApp,Etran de L'Aïr,USD,5.0,1.0,,5.0,,,,0.3,paypal,5.0,0.0,2974005889,,0.5,0.5,0.0,4.2,502.61,4.2,digital download,,http://etrandelair.bandcamp.com/album/music-from-saharan-whatsapp,,WHATSAPP-01,,,Amanda Anderson,valeriegentry@pena.info,(378)699-1337x333,,Kelly Allen,674 Catherine Gateway Apt. 415,,,,,,,,,United States,US,VT,Thetford Center,,
331,1/15/20 11:46pm,Bandcamp,package,Afous d'Afous - Tarhanine Tegla,Afous d'Afous,USD,8.0,1.0,,8.0,,5.0,United States,0.59,credit card,13.0,0.0,2643448781,,0.8,0.8,0.0,11.61,514.22,6.61,Limited 7'' vinyl of Afous d'Afous,,http://afousdafous.bandcamp.com/album/afous-dafous-tarhanine-tegla,SS-035-7,SS-035,889326 668961,,William Navarro,erincollins@brown-owen.com,+1-916-467-8788x96784,,Michael Franco,49970 Rice Branch,,Las Vegas,NV,89138,United States,US,1/21/20,,United States,US,NV,Las Vegas,Bandcamp home page,bandcamp.com/
332,1/15/20 11:56pm,Bandcamp,album,Music from Saharan WhatsApp,Etran de L'Aïr,USD,3.0,1.0,,3.0,,,,0.23,paypal,3.0,0.0,3530767811,,0.3,0.3,0.0,2.47,516.69,2.47,digital download,,http://etrandelair.bandcamp.com/album/music-from-saharan-whatsapp,,WHATSAPP-01,,,James Mcdonald,gregorycannon@gmail.com,+1-925-352-9789x3507,,Stephen Riley,8271 Jesse Hill,,,,,,,,,United Kingdom,GB,Sheffield,Sheffield,Twitter,t.co/1YMVMYCIbh?amp=1
333,1/15/20 11:57pm,Bandcamp,album,Music from Saharan WhatsApp,Etran de L'Aïr,USD,1.0,1.0,,1.0,,,,0.1,credit card,1.0,0.0,1858841225,,0.1,0.1,0.0,0.8,517.49,0.8,digital download,,http://etrandelair.bandcamp.com/album/music-from-saharan-whatsapp,,WHATSAPP-01,,,Melissa Baker,lfisher@hotmail.com,+1-428-061-5065,Love that whatsapp is the successor to cellphones.,Anthony Huff,412 Mcfarland Flats Apt. 858,,,,,,,,,United States,US,CA,Los Angeles,Google search,www.google.com/
334,1/16/20 12:13am,Bandcamp,album,Music from Saharan WhatsApp,Etran de L'Aïr,USD,5.0,1.0,,5.0,,,,0.3,paypal,5.0,0.0,1965992226,,0.5,0.5,0.0,4.2,521.69,4.2,digital download,,http://etrandelair.bandcamp.com/album/music-from-saharan-whatsapp,,WHATSAPP-01,,,David Johnson,williamschristopher@ruiz.com,0311954544,,Joseph Henderson,863 Darlene Village Suite 699,,,,,,,,,United States,US,MO,St Louis,,
335,1/16/20 12:47am,Bandcamp,album,Music from Saharan WhatsApp,Etran de L'Aïr,USD,1.0,1.0,,1.0,,,,0.1,paypal,1.0,0.0,630917474,,0.1,0.1,0.0,0.8,522.49,0.8,digital download,,http://etrandelair.bandcamp.com/album/music-from-saharan-whatsapp,,WHATSAPP-01,,,Melissa Martin,jason73@yahoo.com,568.146.4429x482,,Jason Nguyen,2518 Ramirez Extension,,,,,,,,,United States,US,NC,Chapel Hill,,
336,1/16/20 12:51am,Bandcamp,album,Music from Saharan WhatsApp,Etran de L'Aïr,USD,10.0,1.0,,10.0,,,,0.49,paypal,10.0,0.0,3394772607,,1.0,1.0,0.0,8.51,531.0,8.51,digital download,,http://etrandelair.bandcamp.com/album/music-from-saharan-whatsapp,,WHATSAPP-01,,,Briana Ortiz,davisjennifer@gmail.com,9332424062,,Natalie Briggs,9450 Harper Inlet,,,,,,,,,United States,US,PA,Pittsburgh,,
337,1/16/20 1:21am,Bandcamp,album,Music from Saharan WhatsApp,Etran de L'Aïr,USD,5.0,1.0,,5.0,,,,0.35,credit card,5.0,0.0,3567772284,,0.5,0.5,0.0,4.15,535.15,4.15,digital download,,http://etrandelair.bandcamp.com/album/music-from-saharan-whatsapp,,WHATSAPP-01,,,Louis Hill,jeremyhuffman@gmail.com,759.554.1949x07449,,Gregory Krueger,210 Moses Roads Suite 050,,,,,,,,,New Zealand,NZ,Canterbury,Christchurch,,
338,1/16/20 1:55am,Bandcamp,album,Music from Saharan WhatsApp,Etran de L'Aïr,USD,3.0,1.0,,3.0,,,,0.23,paypal,3.0,0.0,1699115819,,0.3,0.3,0.0,2.47,537.62,2.47,digital download,,http://etrandelair.bandcamp.com/album/music-from-saharan-whatsapp,,WHATSAPP-01,,,Gary Johnson,ronaldthompson@yahoo.com,056.826.2795,,Juan Rodriguez,9248 Katherine Flat Suite 982,,,,,,,,,Australia,AU,VIC,Melbourne,,
339,1/16/20 2:56am,Bandcamp,package,Mali Kady,Luka Productions,USD,8.0,1.0,,8.0,,4.0,United States,0.53,paypal,12.0,0.0,1043538595,,0.8,0.8,0.0,10.67,548.29,6.67,Luka Productions Cassette,,http://lukaproductions.bandcamp.com/album/mali-kady,SSC-016cass,SSC-016,889326 664925,,Juan Decker,marissa50@gmail.com,+1-657-450-1239,,Jacqueline Miller,27803 Smith Landing,Apt C3,Deerfield Beach,FL,33442,United States,US,1/21/20,,United States,US,FL,Deerfield Beach,,
340,1/16/20 3:06am,Bandcamp,album,Music from Saharan WhatsApp,Etran de L'Aïr,USD,1.0,1.0,,1.0,,,,0.1,paypal,1.0,0.0,2088870916,,0.1,0.1,0.0,0.8,549.09,0.8,digital download,,http://etrandelair.bandcamp.com/album/music-from-saharan-whatsapp,,WHATSAPP-01,,,David Warren,owells@gmail.com,(313)533-2411x4459,,Sandra Williams,006 Brenda Harbors Suite 869,,,,,,,,,United States,US,CA,Los Angeles,,
341,1/16/20 3:11am,Bandcamp,album,Music from Saharan WhatsApp,Etran de L'Aïr,USD,10.0,1.0,,10.0,,,,0.52,credit card,10.0,0.0,328243391,,1.0,1.0,0.0,8.48,557.57,8.48,digital download,,http://etrandelair.bandcamp.com/album/music-from-saharan-whatsapp,,WHATSAPP-01,,,Lindsay Harris,sullivanpaula@hill.com,+1-230-725-3315,,Shawn Humphrey,424 Gutierrez Locks,,,,,,,,,United States,US,NY,New York,,
342,1/16/20 3:21am,Bandcamp,album,Music from Saharan WhatsApp,Etran de L'Aïr,USD,1.0,1.0,,1.0,,,,0.1,paypal,1.0,0.0,3941874548,,0.1,0.1,0.0,0.8,558.37,0.8,digital download,,http://etrandelair.bandcamp.com/album/music-from-saharan-whatsapp,,WHATSAPP-01,,,Savannah Whitney,hilljennifer@gmail.com,444.886.6612,,David Horton,95165 Hahn Pike,,,,,,,,,United States,US,OR,Corvallis,Publish notice sent to your fans,
343,1/16/20 3:43am,Bandcamp,album,Music from Saharan WhatsApp,Etran de L'Aïr,USD,1.0,1.0,,1.0,,,,0.11,credit card,1.0,0.0,3184012578,,0.1,0.1,0.0,0.79,559.16,0.79,digital download,,http://etrandelair.bandcamp.com/album/music-from-saharan-whatsapp,,WHATSAPP-01,,,Misty Price,carlosluna@yahoo.com,420-371-2588x16510,,Rebecca Brown,1156 Paige Bridge,,,,,,,,,New Zealand,NZ,Waikato,Hamilton,Bandcamp fan wishlist,bandcamp.com/haminoon
344,1/16/20 3:48am,Bandcamp,album,Music from Saharan WhatsApp,Etran de L'Aïr,USD,1.0,1.0,,1.0,,,,0.11,credit card,1.0,0.0,110417859,,0.1,0.1,0.0,0.79,559.95,0.79,digital download,,http://etrandelair.bandcamp.com/album/music-from-saharan-whatsapp,,WHATSAPP-01,,,Miguel Horn,kcook@yahoo.com,+1-991-447-4526,,Devin Blackburn,75763 Holmes Hill,,,,,,,,,Mexico,MX,Baja California,Tijuana,Bandcamp search,bandcamp.com/autocomplete-search
345,1/16/20 3:52am,Bandcamp,album,Music from Saharan WhatsApp,Etran de L'Aïr,USD,2.0,1.0,,2.0,,,,0.15,paypal,2.0,0.0,288877086,,0.2,0.2,0.0,1.65,561.6,1.65,digital download,,http://etrandelair.bandcamp.com/album/music-from-saharan-whatsapp,,WHATSAPP-01,,,Kenneth Bradley,toddwebb@yahoo.com,+1-611-234-6000x8806,,Angela Vega,298 Potter Crest Suite 589,,,,,,,,,United States,US,WA,Seattle,Bandcamp sales feed,bandcamp.com/#selling-now
346,1/16/20 4:11am,Bandcamp,album,Music from Saharan Cellphones,Various,USD,7.0,1.0,,7.0,,,,0.57,paypal,7.0,0.0,723023457,,0.7,0.0,0.7,0.0,561.6,5.73,digital download,,http://sahelsounds.bandcamp.com/album/music-from-saharan-cellphones,,SS-003,889326 667889,,Jeremiah Watts,dustingray@gmail.com,8601262232,,Cory Bray,914 Thomas Manors,,,,,,,,,United States,US,MA,Jamaica Plain,Google search,www.google.com/
347,1/16/20 4:11am,Bandcamp,album,Balani Show Super Hits: Electronic Street Parties from Mali,Various,USD,7.0,1.0,,7.0,,,,,,7.0,0.0,723023457,,0.7,1.4,0.0,12.03,573.63,6.3,digital download,,http://sahelsounds.bandcamp.com/album/balani-show-super-hits-electronic-street-parties-from-mali,,SS-021,889326 667643,,Jeremiah Watts,kramerjohn@hotmail.com,001-574-628-9306,,Thomas Krause,604 Alexander Garden Suite 797,,,,,,,,,United States,US,MA,Jamaica Plain,Google search,www.google.com/
348,1/16/20 4:43am,Bandcamp,album,Music from Saharan WhatsApp,Etran de L'Aïr,USD,4.0,1.0,,4.0,,,,0.29,paypal,4.0,0.0,2809910878,,0.4,0.4,0.0,3.31,576.94,3.31,digital download,,http://etrandelair.bandcamp.com/album/music-from-saharan-whatsapp,,WHATSAPP-01,,,Stacey Davis,wgordon@gmail.com,001-502-461-5032x3662,,Teresa Riley,62166 Stephens Manors Apt. 375,,,,,,,,,Australia,AU,VIC,Fitzroy,,
349,1/16/20 4:49am,Bandcamp,album,Music from Saharan Cellphones,Various,USD,7.0,1.0,,7.0,,,,0.4,credit card,7.0,0.0,636221222,,0.7,0.7,0.0,5.9,582.84,5.9,digital download,,http://sahelsounds.bandcamp.com/album/music-from-saharan-cellphones,,SS-003,889326 667889,,Brad Blackwell,katherine69@vasquez.com,695.057.6847,,Timothy Wheeler,96844 John Plains,,,,,,,,,United States,US,DC,Washington,t.umblr.com,t.umblr.com/
350,1/16/20 4:53am,Bandcamp,album,Music from Saharan WhatsApp,Etran de L'Aïr,USD,5.0,1.0,,5.0,,,,0.3,paypal,5.0,0.0,1240197884,,0.5,0.5,0.0,4.2,587.04,4.2,digital download,,http://etrandelair.bandcamp.com/album/music-from-saharan-whatsapp,,WHATSAPP-01,,,Kristen Matthews,martineztina@hotmail.com,430-135-3099x7344,,Kathryn Keller,07552 Brent Landing Suite 871,,,,,,,,,United States,US,VA,Charlottesville,Bandcamp release notification: music feed,http://blog.bandcamp.com/2014/01/30/bandcamp-app-now-with-music-feed/
351,1/16/20 4:59am,Bandcamp,album,Music from Saharan WhatsApp,Etran de L'Aïr,USD,3.0,1.0,,3.0,,,,0.2,paypal,3.0,0.0,1524730925,,0.3,0.3,0.0,2.5,589.54,2.5,digital download,,http://etrandelair.bandcamp.com/album/music-from-saharan-whatsapp,,WHATSAPP-01,,,Paula Warren,eibarra@yahoo.com,+1-077-075-6543,,Mark Wong,720 Owens Courts,,,,,,,,,United States,US,CA,Santa Barbara,Publish notice sent to your fans,
352,1/16/20 6:38am,Bandcamp,album,Music from Saharan WhatsApp,Etran de L'Aïr,USD,3.0,1.0,,3.0,,,,0.23,paypal,3.0,0.0,2447555956,,0.3,0.3,0.0,2.47,592.01,2.47,digital download,,http://etrandelair.bandcamp.com/album/music-from-saharan-whatsapp,,WHATSAPP-01,,,Sonya Anderson,lambelizabeth@lang-vazquez.com,(596)182-6766x30203,,Gregory Medina,7850 Adams Brook,,,,,,,,,Germany,DE,Bavaria,Lauingen,Facebook,www.facebook.com
353,1/16/20 6:39am,Bandcamp,album,Music from Saharan WhatsApp,Etran de L'Aïr,USD,3.0,1.0,,3.0,,,,0.2,credit card,3.0,0.0,4027770484,,0.3,0.3,0.0,2.5,594.51,2.5,digital download,,http://etrandelair.bandcamp.com/album/music-from-saharan-whatsapp,,WHATSAPP-01,,,Holly Hill,marshalljoseph@gmail.com,491.839.2167,,Jessica Parker,54993 Karla Fords,,,,,,,,,United States,US,CA,San Diego,Bandcamp fan wishlist,bandcamp.com/sleezsisters
354,1/16/20 7:25am,Bandcamp,album,Music from Saharan WhatsApp,Etran de L'Aïr,USD,2.0,1.0,,2.0,,,,0.17,paypal,2.0,0.0,3631367910,,0.2,0.2,0.0,1.63,596.14,1.63,digital download,,http://etrandelair.bandcamp.com/album/music-from-saharan-whatsapp,,WHATSAPP-01,,,John Moreno,barrydelgado@romero.info,001-480-533-8550x3914,,Kenneth Taylor,33174 Jeremy Corner Apt. 291,,,,,,,,,Burkina Faso,BF,Kadiogo Province,Ouagadougou,,
355,1/16/20 9:32am,Bandcamp,album,Music from Saharan WhatsApp,Etran de L'Aïr,USD,2.0,1.0,,2.0,,,,0.17,credit card,2.0,0.0,2992368417,,0.2,0.2,0.0,1.63,597.77,1.63,digital download,,http://etrandelair.bandcamp.com/album/music-from-saharan-whatsapp,,WHATSAPP-01,,,Nicole Tyler,charlesdixon@huffman-bell.org,(332)425-1014,,Christopher French,9944 Karen Pike,,,,,,,,,Belgium,BE,East Flanders Province,Ghent,Bandcamp music feed,http://blog.bandcamp.com/2014/01/30/bandcamp-app-now-with-music-feed/
356,1/16/20 11:32am,Bandcamp,album,Music from Saharan WhatsApp,Etran de L'Aïr,USD,1.0,1.0,,1.0,,,,0.11,paypal,1.0,0.0,1061504595,,0.1,0.1,0.0,0.79,598.56,0.79,digital download,,http://etrandelair.bandcamp.com/album/music-from-saharan-whatsapp,,WHATSAPP-01,,,Natalie Knight,murrayrobert@yahoo.com,049-962-6230x93549,,Michael Davis,6980 Nicole Parkways,,,,,,,,,Germany,DE,Land Berlin,Berlin,Bandcamp release notification: music feed,http://blog.bandcamp.com/2013/09/19/strap-on-your-feed-bag/
357,1/16/20 12:28pm,Bandcamp,album,Music from Saharan WhatsApp,Etran de L'Aïr,USD,2.0,1.0,,2.0,,,,0.17,paypal,2.0,0.0,3163007952,,0.2,0.2,0.0,1.63,600.19,1.63,digital download,,http://etrandelair.bandcamp.com/album/music-from-saharan-whatsapp,,WHATSAPP-01,,,Laura Hebert,petersontamara@hotmail.com,699-857-4375x470,,Andrew Charles,55574 Carol Dale Suite 458,,,,,,,,,Netherlands,NL,North Brabant,Breda,,
358,1/16/20 1:14pm,Bandcamp,album,Music from Saharan WhatsApp,Etran de L'Aïr,USD,3.0,1.0,,3.0,,,,0.2,paypal,3.0,0.0,2777386361,,0.3,0.3,0.0,2.5,602.69,2.5,digital download,,http://etrandelair.bandcamp.com/album/music-from-saharan-whatsapp,,WHATSAPP-01,,,Katrina Adams,alison63@hotmail.com,+1-740-148-9862x516,,Krystal Smith,2324 Ruiz Meadow,,,,,,,,,United States,US,NC,Raleigh,Bandcamp music feed,http://blog.bandcamp.com/2014/01/30/bandcamp-app-now-with-music-feed/
359,1/16/20 1:36pm,Bandcamp,album,Music from Saharan WhatsApp,Etran de L'Aïr,USD,1.0,1.0,,1.0,,,,0.1,credit card,1.0,0.0,64021679,,0.1,0.1,0.0,0.8,603.49,0.8,digital download,,http://etrandelair.bandcamp.com/album/music-from-saharan-whatsapp,,WHATSAPP-01,,,Jennifer Rodriguez,patricia75@gmail.com,001-933-505-3569,,Taylor Petersen,833 Thomas Creek Suite 873,,,,,,,,,United States,US,PA,Perkasie,Publish notice sent to your fans,
360,1/16/20 2:45pm,Bandcamp,album,Music from Saharan WhatsApp,Etran de L'Aïr,USD,7.0,1.0,,7.0,,,,0.47,paypal,7.0,0.0,4039769396,,0.7,0.7,0.0,5.83,609.32,5.83,digital download,,http://etrandelair.bandcamp.com/album/music-from-saharan-whatsapp,,WHATSAPP-01,,,Julie Lopez,lmiller@roberts.org,585-328-4034x025,,Tara Leon,43222 Daniel Inlet,,,,,,,,,United Kingdom,GB,Lambeth,Streatham,Bandcamp search: “saharan whatsapp”,bandcamp.com/search?q=saharan%20whatsapp
361,1/16/20 2:47pm,Bandcamp,album,Sahel Sounds Label Sampler,Various Artists,USD,3.0,1.0,,3.0,,,,0.23,paypal,3.0,0.0,2868585732,,0.3,0.3,0.0,2.47,611.79,2.47,digital download,,http://sahelsounds.bandcamp.com/album/sahel-sounds-label-sampler,,SS-058,602318 137111,,Julie Lopez,nweeks@yahoo.com,001-664-128-4719,,Erica Sharp,6962 Perry Fords Suite 747,,,,,,,,,United Kingdom,GB,Lambeth,Streatham,bandcamp.com,bandcamp.com
362,1/16/20 3:14pm,Bandcamp,album,Houmeissa,Hama,USD,10.0,1.0,,10.0,,,,0.62,credit card,10.0,0.0,4151719855,,1.0,1.0,0.0,8.38,620.17,8.38,digital download,,http://hamasynth.bandcamp.com/album/houmeissa,,SS-049,656605 382364,,Rachael Palmer,estone@mathews.com,+1-350-346-4448,,Michael Walker,793 Lee Drive Suite 388,,,,,,,,,Canada,CA,,,Bandcamp Daily: the-best-albums-of-2019-80-61,daily.bandcamp.com/best-of-2019/the-best-albums-of-2019-80-61
363,1/16/20 3:21pm,Bandcamp,album,Tenere,Afous d'Afous,USD,7.0,1.0,,7.0,,,,0.4,paypal,7.0,0.0,3788384819,,0.7,0.7,0.0,5.9,626.07,5.9,digital download,,http://afousdafous.bandcamp.com/album/tenere,,SS-042,191515 490421,,Tracy Shepard,vadams@mora-brooks.com,+1-765-037-6036,,Chad Lee,1261 Wilson Inlet Suite 104,,,,,,,,,United States,US,,,,
364,1/16/20 3:24pm,Bandcamp,album,Afous d'Afous - Tarhanine Tegla,Afous d'Afous,USD,4.0,1.0,,4.0,,,,0.25,paypal,4.0,0.0,457158665,,0.4,0.4,0.0,3.35,629.42,3.35,digital download,,http://afousdafous.bandcamp.com/album/afous-dafous-tarhanine-tegla,,SS-035,889326 668961,,Tracy Shepard,andrewhenry@cooper-byrd.com,9684056788,,Virginia Spencer,500 Jessica Parkways,,,,,,,,,United States,US,,,,
365,1/16/20 3:33pm,Bandcamp,album,Music from Saharan WhatsApp,Etran de L'Aïr,USD,2.0,1.0,,2.0,,,,0.15,paypal,2.0,0.0,3915185707,,0.2,0.2,0.0,1.65,631.07,1.65,digital download,,http://etrandelair.bandcamp.com/album/music-from-saharan-whatsapp,,WHATSAPP-01,,,Victoria Munoz,dawnkim@gmail.com,650.267.3597,,Pamela Russell,730 Cuevas Valleys Apt. 227,,,,,,,,,United States,US,DC,Washington,,
366,1/16/20 3:47pm,Bandcamp,package,Ilana: The Creator,Mdou Moctar,USD,30.0,1.0,,30.0,,5.0,United States,1.07,credit card,35.0,0.0,4064743243,,3.0,3.0,0.0,30.93,662.0,25.93,Ilana: The Creator shirt,Small,http://mdoumoctar.bandcamp.com/merch/ilana-the-creator-shirt,SS-MDOU-BIRD-SHIRT-S,,,,Justin Hartman,jeremy37@gmail.com,739-161-3608,,Stacey Bush,642 Hernandez Walks,,Denton,TX,76201,United States,US,1/21/20,,United States,US,TX,Denton,Google search,www.google.com/
367,1/16/20 3:50pm,Bandcamp,album,Music from Saharan WhatsApp,Etran de L'Aïr,USD,3.0,1.0,,3.0,,,,0.2,credit card,3.0,0.0,2876614577,,0.3,0.3,0.0,2.5,664.5,2.5,digital download,,http://etrandelair.bandcamp.com/album/music-from-saharan-whatsapp,,WHATSAPP-01,,,Malik Armstrong,sullivanpamela@gmail.com,001-695-452-0403x2365,,Thomas Morgan,93269 Ernest Ferry Apt. 735,,,,,,,,,United States,US,NY,New York,Publish notice sent to your fans,
368,1/16/20 3:54pm,Bandcamp,album,Music from Saharan WhatsApp,Etran de L'Aïr,USD,3.0,1.0,,3.0,,,,0.2,paypal,3.0,0.0,280262120,,0.3,0.3,0.0,2.5,667.0,2.5,digital download,,http://etrandelair.bandcamp.com/album/music-from-saharan-whatsapp,,WHATSAPP-01,,,Chelsea Jacobs,danielwalker@roberts-thomas.biz,+1-491-403-0863,,Melanie Owen,61595 Allen Spur Apt. 035,,,,,,,,,United States,US,NY,New York,Publish notice sent to your fans,
369,1/16/20 4:59pm,Bandcamp,album,Torodi,Hama,USD,7.0,1.0,,7.0,,,,0.4,credit card,7.0,0.0,1703748265,,0.7,0.7,0.0,5.9,672.9,5.9,digital download,,http://hamasynth.bandcamp.com/album/torodi,,SS-025,889326 664833,,James Levy,tonymoore@collins-paul.net,+1-727-204-9099x991,,Kevin Davis,8762 Shaffer Isle,,,,,,,,,United States,US,CA,El Sobrante,Bandcamp Daily (embedded player): hama-feature,daily.bandcamp.com/2019/02/27/hama-feature/
370,1/16/20 5:00pm,Bandcamp,album,Ilana: The Creator,Mdou Moctar,USD,10.0,1.0,,10.0,,,,0.49,paypal,10.0,0.0,3573693267,,1.0,1.0,0.0,8.51,681.41,8.51,digital download,,http://mdoumoctar.bandcamp.com/album/ilana-the-creator,,SS-051,602318 136893,,Michael Mcgee,dfields@lopez.com,136-086-8361x9042,Please never stop making music. Much love!,Dana Nguyen,577 Williams Terrace,,,,,,,,,United States,US,NH,Nashua,Google search,www.google.com/
371,1/16/20 5:46pm,Bandcamp,album,Music from Saharan WhatsApp,Etran de L'Aïr,USD,5.0,1.0,,5.0,,,,0.3,paypal,5.0,0.0,3178052620,,0.5,0.5,0.0,4.2,685.61,4.2,digital download,,http://etrandelair.bandcamp.com/album/music-from-saharan-whatsapp,,WHATSAPP-01,,,Shannon Gomez,haydenchristine@willis.com,(846)368-3760x64782,,Amanda Burton,126 Hansen Brook,,,,,,,,,United States,US,NV,Las Vegas,Bandcamp release notification: music feed,http://blog.bandcamp.com/2014/01/30/bandcamp-app-now-with-music-feed/
372,1/16/20 6:02pm,shop@sahelsounds.com,payout,,,USD,,,,,,,,0.84,transfer,84.44,83.6,t251700966,8Y649532KB525224R,,,,-84.44,601.17,,,,,,,,,,,,,,,,,,,,,,,,,,,,
373,1/16/20 6:02pm,shop@sahelsounds.com,payout,,,USD,,,,,,,,1.59,transfer,159.39,157.8,t251700967,7RW259488D867841H,,,,-159.39,441.78,,,,,,,,,,,,,,,,,,,,,,,,,,,,
374,1/16/20 6:30pm,Bandcamp,album,Music from Saharan WhatsApp,Etran de L'Aïr,USD,1.5,1.0,,1.5,,,,0.14,credit card,1.5,0.0,3298645145,,0.15,0.15,0.0,1.21,442.99,1.21,digital download,,http://etrandelair.bandcamp.com/album/music-from-saharan-whatsapp,,WHATSAPP-01,,,Jack Young,esims@ibarra.com,0074777028,,Edward Thompson,7026 Vega Place Suite 398,,,,,,,,,France,FR,Saône-et-Loire,Ciry-le-Noble,,
375,1/16/20 6:31pm,Bandcamp,album,Music from Saharan WhatsApp,Etran de L'Aïr,USD,2.0,1.0,,2.0,,,,0.17,paypal,2.0,0.0,1834729072,,0.2,0.2,0.0,1.63,444.62,1.63,digital download,,http://etrandelair.bandcamp.com/album/music-from-saharan-whatsapp,,WHATSAPP-01,,,Richard Sweeney,ymartin@gmail.com,001-859-764-1441x338,,Debbie Young,7576 Brown Falls Apt. 688,,,,,,,,,United Kingdom,GB,England,London,Bandcamp search,bandcamp.com/app/android/search
376,1/16/20 6:49pm,Bandcamp,album,Sahel Sounds Label Sampler,Various Artists,USD,2.0,1.0,,2.0,,,,0.17,paypal,2.0,0.0,1786895883,,0.2,0.2,0.0,1.63,446.25,1.63,digital download,,http://sahelsounds.bandcamp.com/album/sahel-sounds-label-sampler,,SS-058,602318 137111,,Matthew Jordan,albert51@foster.com,941.804.5388x2927,,Victor Smith,5534 Simon Isle Suite 205,,,,,,,,,Ireland,IE,Leinster,Dublin,Google search,www.google.com/
377,1/16/20 6:50pm,Bandcamp,album,Ilana: The Creator,Mdou Moctar,USD,10.0,1.0,,10.0,,,,0.49,paypal,10.0,0.0,1178440666,,1.0,1.0,0.0,8.51,454.76,8.51,digital download,,http://mdoumoctar.bandcamp.com/album/ilana-the-creator,,SS-051,602318 136893,,William Allen,landerson@hotmail.com,585-063-2650x2239,,Amanda Hall,014 Carrie Station Apt. 104,,,,,,,,,United States,US,GA,Savannah,Publish notice sent to your fans,
378,1/16/20 6:52pm,Bandcamp,album,Field Recordings from the Sahel,Sahel Sounds,USD,2.0,1.0,,2.0,,,,0.17,paypal,2.0,0.0,1183177565,,0.2,0.2,0.0,1.63,456.39,1.63,digital download,,http://sahelsounds.bandcamp.com/album/field-recordings-from-the-sahel,,SS-057,602318 137104,,Matthew Jordan,crystal31@gmail.com,(818)765-4922x349,,Yolanda Smith,89889 Troy Corner,,,,,,,,,Ireland,IE,Leinster,Dublin,Bandcamp fan page: roostercogburn,bandcamp.com/roostercogburn
379,1/16/20 7:07pm,Bandcamp,album,Music from Saharan WhatsApp,Etran de L'Aïr,USD,1.5,1.0,,1.5,,,,0.13,paypal,1.5,0.0,3144595767,,0.15,0.15,0.0,1.22,457.61,1.22,digital download,,http://etrandelair.bandcamp.com/album/music-from-saharan-whatsapp,,WHATSAPP-01,,,Melvin Oneal,smithgerald@yahoo.com,652-907-7839x655,,Bryce Morgan,11736 Chambers Gardens,,,,,,,,,United States,US,CO,Delta,Bandcamp app discover,bandcamp.com/app/android/discover
380,1/16/20 7:13pm,Bandcamp,album,Music from Saharan WhatsApp,Etran de L'Aïr,USD,1.0,1.0,,1.0,,,,0.1,credit card,1.0,0.0,2935362417,,0.1,0.1,0.0,0.8,458.41,0.8,digital download,,http://etrandelair.bandcamp.com/album/music-from-saharan-whatsapp,,WHATSAPP-01,,,David Williams,pbyrd@yahoo.com,(226)010-5573x16151,,Adriana Lara,1079 Schmidt Squares Apt. 616,,,,,,,,,United States,US,NH,Portsmouth,Bandcamp fan wishlist,bandcamp.com/chip11under
381,1/16/20 7:17pm,Bandcamp,album,Music from Saharan WhatsApp,Etran de L'Aïr,USD,1.0,1.0,,1.0,,,,0.11,paypal,1.0,0.0,3956159328,,0.1,0.1,0.0,0.79,459.2,0.79,digital download,,http://etrandelair.bandcamp.com/album/music-from-saharan-whatsapp,,WHATSAPP-01,,,Scott Morgan,vazquezdennis@villegas.biz,182-252-7403x62922,,Matthew Hamilton,1874 Mitchell Ferry,,,,,,,,,United Kingdom,GB,Bristol,Bristol,Google search,www.google.com/
382,1/16/20 7:26pm,Bandcamp,album,Sahel Sounds Label Sampler,Various Artists,USD,5.0,1.0,,5.0,,,,0.3,paypal,5.0,0.0,2314848367,,0.5,0.5,0.0,4.2,463.4,4.2,digital download,,http://sahelsounds.bandcamp.com/album/sahel-sounds-label-sampler,,SS-058,602318 137111,,Kristina Obrien,williamschristopher@yahoo.com,(116)388-3044x2721,,Tony Schwartz,1256 Hill Drive Apt. 177,,,,,,,,,United States,US,PA,Blue Bell,,
383,1/16/20 7:39pm,Bandcamp,album,Sahel Sounds Label Sampler,Various Artists,USD,1.0,1.0,,1.0,,,,0.45,paypal,1.0,0.0,1654683491,,0.1,0.0,0.1,0.0,463.4,0.45,digital download,,http://sahelsounds.bandcamp.com/album/sahel-sounds-label-sampler,,SS-058,602318 137111,,Gregory Ramirez,james32@thomas.biz,+1-793-349-6994,,Sarah Burke,9295 Thompson Orchard Suite 754,,,,,,,,,United States,US,CA,Santa Cruz,,
384,1/16/20 7:39pm,Bandcamp,album,Eghass Malan,Les Filles de Illighadad,USD,7.0,1.0,,7.0,,,,,,7.0,0.0,1654683491,,0.7,0.8,0.0,6.75,470.15,6.3,digital download,,http://lesfillesdeillighadad.bandcamp.com/album/eghass-malan,,SS-044,191515 928351,,Gregory Ramirez,jordankim@gmail.com,731-159-4148,,Jacob Young,462 Laurie Crescent Suite 892,,,,,,,,,United States,US,CA,Santa Cruz,,
385,1/16/20 8:32pm,Bandcamp,package,Sahel Sounds Label Sampler,Various Artists,USD,20.0,1.0,,20.0,,5.0,United States,0.78,paypal,25.0,0.0,2830367066,,2.0,2.0,0.0,22.22,492.37,17.22,Sahel Sounds t-shirt,Medium,http://sahelsounds.bandcamp.com/merch/sahel-sounds-t-shirt,SS-T01-BLK-UMD,,,,Charles White,bruce63@yahoo.com,299.815.6080x31921,,Guy Sparks,2945 Lawson Flats Suite 131,,Milwaukee,WI,53207,United States,US,1/21/20,,United States,US,WI,Milwaukee,Google search,www.google.com/
386,1/16/20 8:48pm,Bandcamp,album,Music from Saharan WhatsApp,Etran de L'Aïr,USD,5.0,1.0,,5.0,,,,0.35,paypal,5.0,0.0,1819620676,,0.5,0.5,0.0,4.15,496.52,4.15,digital download,,http://etrandelair.bandcamp.com/album/music-from-saharan-whatsapp,,WHATSAPP-01,,,Denise Gordon,mendozabarbara@hernandez.com,021.208.3345x264,,Megan Morris,11961 Rebecca Cliff,,,,,,,,,Germany,DE,Land Berlin,Berlin,Bandcamp artist: sahelsounds,sahelsounds.bandcamp.com/album/music-from-saharan-cellphones
387,1/16/20 8:59pm,Bandcamp,album,Music from Saharan WhatsApp,Etran de L'Aïr,USD,5.0,1.0,,5.0,,,,0.3,paypal,5.0,0.0,3444028556,,0.5,0.5,0.0,4.2,500.72,4.2,digital download,,http://etrandelair.bandcamp.com/album/music-from-saharan-whatsapp,,WHATSAPP-01,,,Benjamin Herring,darrellstewart@collins.info,(876)162-9040x959,,Isabella Simpson,26615 Bernard Ports Apt. 398,,,,,,,,,United States,US,NJ,Hillsborough,Bandcamp fan wishlist,bandcamp.com/dpk
388,1/16/20 9:16pm,Bandcamp,album,Music from Saharan WhatsApp,Etran de L'Aïr,USD,1.0,1.0,,1.0,,,,0.11,paypal,1.0,0.0,106035770,,0.1,0.1,0.0,0.79,501.51,0.79,digital download,,http://etrandelair.bandcamp.com/album/music-from-saharan-whatsapp,,WHATSAPP-01,,,Elizabeth Zhang,romerojorge@hotmail.com,225.827.2773x5899,,Joshua Suarez,819 Ford Course Apt. 650,,,,,,,,,Netherlands,NL,South Holland,Rijswijk,Google search,www.google.com/
389,1/16/20 10:06pm,Bandcamp,album,Music from Saharan WhatsApp,Etran de L'Aïr,USD,1.0,1.0,,1.0,,,,0.11,paypal,1.0,0.0,3791076811,,0.1,0.1,0.0,0.79,502.3,0.79,digital download,,http://etrandelair.bandcamp.com/album/music-from-saharan-whatsapp,,WHATSAPP-01,,,Alexandra Sosa,michael53@gmail.com,001-181-524-2693x3609,,David Ayala,93668 Wise Drive,,,,,,,,,United Kingdom,GB,Stockport,Stockport,,
390,1/16/20 10:28pm,Bandcamp,album,Music from Saharan WhatsApp,Etran de L'Aïr,USD,1.0,1.0,,1.0,,,,0.1,paypal,1.0,0.0,1710459860,,0.1,0.1,0.0,0.8,503.1,0.8,digital download,,http://etrandelair.bandcamp.com/album/music-from-saharan-whatsapp,,WHATSAPP-01,,,Derek Dunn,kyle45@yahoo.com,7984773146,,Herbert Mueller,0319 Angela Inlet,,,,,,,,,United States,US,DC,Washington,Bandcamp release notification: music feed,http://blog.bandcamp.com/2013/09/19/strap-on-your-feed-bag/
391,1/16/20 10:56pm,Bandcamp,album,Music from Saharan WhatsApp,Etran de L'Aïr,USD,12.0,1.0,,12.0,,,,0.65,paypal,12.0,0.0,1367701192,,1.2,1.2,0.0,10.15,513.25,10.15,digital download,,http://etrandelair.bandcamp.com/album/music-from-saharan-whatsapp,,WHATSAPP-01,,,Angela Bell,mannjessica@yahoo.com,+1-155-063-6471x4400,,Nicole Turner,1202 Ray Spurs Apt. 491,,,,,,,,,Spain,ES,Valencia,Valencia,Facebook,www.facebook.com
392,1/16/20 10:58pm,Bandcamp,album,Music from Saharan Cellphones,Various,USD,7.0,1.0,,7.0,,,,0.57,paypal,7.0,0.0,330935004,,0.7,0.0,0.7,0.0,513.25,5.73,digital download,,http://sahelsounds.bandcamp.com/album/music-from-saharan-cellphones,,SS-003,889326 667889,,Douglas Rice,devin31@cochran.com,001-656-694-9606x661,,Mary Jordan,40474 Victoria Circle Apt. 325,,,,,,,,,United States,US,LA,Cut Off,Bandcamp artist: sahelsounds,sahelsounds.bandcamp.com
393,1/16/20 10:58pm,Bandcamp,album,Music from Saharan Cellphones: Volume 2,Various,USD,7.0,1.0,,7.0,,,,,,7.0,0.0,330935004,,0.7,1.4,0.0,12.03,525.28,6.3,digital download,,http://sahelsounds.bandcamp.com/album/music-from-saharan-cellphones-volume-2,,SS-012,889326 667742,,Douglas Rice,leahgarcia@butler.com,880.116.0356x8107,,Yvonne Hernandez,30398 Eric Track Suite 269,,,,,,,,,United States,US,LA,Cut Off,Bandcamp artist: sahelsounds,sahelsounds.bandcamp.com
394,1/16/20 11:32pm,Bandcamp,album,Issawat,Idassane Wallet Mohamed,USD,7.0,1.0,,7.0,,,,1.92,paypal,7.0,0.0,3697960482,,0.7,0.0,0.7,0.0,525.28,4.38,digital download,,http://idassanewalletmohamed.bandcamp.com/album/issawat,,SS-015,889326 667766,,Kenneth Wiggins,pcarroll@clay-espinoza.com,(361)091-1818x686,,Paul Munoz,7057 Haley Ports Apt. 772,,,,,,,,,Australia,AU,VIC,Surrey Hills,,
395,1/16/20 11:32pm,Bandcamp,album,Torodi,Hama,USD,7.0,1.0,,7.0,,,,,,7.0,0.0,3697960482,,0.7,0.0,1.4,0.0,525.28,6.3,digital download,,http://hamasynth.bandcamp.com/album/torodi,,SS-025,889326 664833,,Kenneth Wiggins,aaron45@blanchard.biz,001-620-936-8293x9434,,Michael Miller,31481 Nicholas Manors,,,,,,,,,Australia,AU,VIC,Surrey Hills,,
396,1/16/20 11:32pm,Bandcamp,album,Waande Kadde,Amadou Binta Konté and Tidiane Thiam,USD,7.0,1.0,,7.0,,,,,,7.0,0.0,3697960482,,0.7,0.0,2.1,0.0,525.28,6.3,digital download,,http://sahelsounds.bandcamp.com/album/waande-kadde,,SS-036 / SFH-01,889326 796008,,Kenneth Wiggins,lauren44@pitts.info,568.764.9246x76143,,Angela Stevens,8411 Daniel Burg Apt. 241,,,,,,,,,Australia,AU,VIC,Surrey Hills,,
397,1/16/20 11:32pm,Bandcamp,album,Agrim Agadez,Various,USD,7.0,1.0,,7.0,,,,,,7.0,0.0,3697960482,,0.7,0.0,2.8,0.0,525.28,6.3,digital download,,http://sahelsounds.bandcamp.com/album/agrim-agadez,,SS-038,889326 872382,,Kenneth Wiggins,nicole67@gmail.com,633.970.9697,,Steven Villarreal,90985 Lee Estate Apt. 125,,,,,,,,,Australia,AU,VIC,Surrey Hills,,
398,1/16/20 11:32pm,Bandcamp,album,Sahel Sounds Label Sampler,Various Artists,USD,7.0,1.0,,7.0,,,,,,7.0,0.0,3697960482,,0.7,0.0,3.5,0.0,525.28,6.3,digital download,,http://sahelsounds.bandcamp.com/album/sahel-sounds-label-sampler,,SS-058,602318 137111,,Kenneth Wiggins,murphywendy@gonzalez.biz,876-803-0681x749,,Travis Taylor,4288 Christopher Valley,,,,,,,,,Australia,AU,VIC,Surrey Hills,,
399,1/16/20 11:32pm,Bandcamp,album,Les Filles de Illighadad,Les Filles de Illighadad,USD,7.0,1.0,,7.0,,,,,,7.0,0.0,3697960482,,0.7,0.0,4.2,0.0,525.28,6.3,digital download,,http://lesfillesdeillighadad.bandcamp.com/album/les-filles-de-illighadad,,SS-033,889326 664918,,Kenneth Wiggins,wmitchell@hotmail.com,979-877-7203,,Jessica Morris,9650 Joseph Fall,,,,,,,,,Australia,AU,VIC,Surrey Hills,,
400,1/16/20 11:32pm,Bandcamp,album,Eghass Malan,Les Filles de Illighadad,USD,7.0,1.0,,7.0,,,,,,7.0,0.0,3697960482,,0.7,0.0,4.9,0.0,525.28,6.3,digital download,,http://lesfillesdeillighadad.bandcamp.com/album/eghass-malan,,SS-044,191515 928351,,Kenneth Wiggins,conleypeter@young-allen.net,985.458.1416x22680,,David Rangel,870 Rogers Club,,,,,,,,,Australia,AU,VIC,Surrey Hills,,
401,1/16/20 11:32pm,Bandcamp,album,Isswat,Fadimoutou Wallet Inamoud,USD,7.0,1.0,,7.0,,,,,,7.0,0.0,3697960482,,0.7,5.6,0.0,48.48,573.76,6.3,digital download,,http://fadimoutouwalletinamoud.bandcamp.com/album/isswat,,SS-026,889326 667872,,Kenneth Wiggins,james82@hotmail.com,(144)940-4138x05947,,James Cannon,07421 Brittany Rapids,,,,,,,,,Australia,AU,VIC,Surrey Hills,,
402,1/16/20 11:40pm,Bandcamp,album,Les Filles de Illighadad,Les Filles de Illighadad,USD,10.0,1.0,,10.0,,,,0.52,credit card,10.0,0.0,839052531,,1.0,1.0,0.0,8.48,582.24,8.48,digital download,,http://lesfillesdeillighadad.bandcamp.com/album/les-filles-de-illighadad,,SS-033,889326 664918,,Jennifer Cross,joshua22@white-johnson.com,001-787-310-8700x81027,,Heather Crosby,2496 Becker Manor Suite 746,,,,,,,,,United States,US,WA,Seattle,Google search,www.google.com/
403,1/17/20 12:39am,Bandcamp,album,Music from Saharan WhatsApp,Etran de L'Aïr,USD,5.0,1.0,,5.0,,,,0.3,paypal,5.0,0.0,4140604239,,0.5,0.5,0.0,4.2,586.44,4.2,digital download,,http://etrandelair.bandcamp.com/album/music-from-saharan-whatsapp,,WHATSAPP-01,,,Rachel Moreno,ecox@gmail.com,(376)303-7100x279,,Tanya Williams,087 Tammy Place Suite 575,,,,,,,,,United States,US,FL,Orlando,,
404,1/17/20 1:04am,Bandcamp,album,Music from Saharan WhatsApp,Etran de L'Aïr,USD,4.0,1.0,,4.0,,,,0.25,paypal,4.0,0.0,683407634,,0.4,0.4,0.0,3.35,589.79,3.35,digital download,,http://etrandelair.bandcamp.com/album/music-from-saharan-whatsapp,,WHATSAPP-01,,,Brenda Hays,jenkinsbrian@hotmail.com,025-716-2760x510,,Ronald Roberts,39515 Shea Garden,,,,,,,,,United States,US,MD,Catonsville,Bandcamp fan wishlist,bandcamp.com/jeffstein
405,1/17/20 2:02am,Bandcamp,album,Music from Saharan WhatsApp,Etran de L'Aïr,USD,1.0,1.0,,1.0,,,,0.11,credit card,1.0,0.0,2192831018,,0.1,0.1,0.0,0.79,590.58,0.79,digital download,,http://etrandelair.bandcamp.com/album/music-from-saharan-whatsapp,,WHATSAPP-01,,,Joanna Johnson,chad20@hotmail.com,7124811152,,Olivia Bennett,073 Bryan Shoals,,,,,,,,,Japan,JP,Tokyo,Shinjuku,Bandcamp New & Notable,bandcamp.com/#new-notable
406,1/17/20 2:05am,Bandcamp,album,Music from Saharan WhatsApp,Etran de L'Aïr,USD,3.0,1.0,,3.0,,,,0.2,credit card,3.0,0.0,1225830613,,0.3,0.3,0.0,2.5,593.08,2.5,digital download,,http://etrandelair.bandcamp.com/album/music-from-saharan-whatsapp,,WHATSAPP-01,,,Mary Mckee,xwilson@gmail.com,322.492.8804x7631,,Michelle Kelly,5616 Lewis Avenue,,,,,,,,,United States,US,OR,Portland,,
407,1/17/20 2:20am,Bandcamp,album,Music from Saharan WhatsApp,Etran de L'Aïr,USD,5.0,1.0,,5.0,,,,0.35,paypal,5.0,0.0,2710326493,,0.5,0.5,0.0,4.15,597.23,4.15,digital download,,http://etrandelair.bandcamp.com/album/music-from-saharan-whatsapp,,WHATSAPP-01,,,Jean Harvey,amanda34@hotmail.com,+1-984-243-9573x93271,,Charles Johnson,97171 Miller Unions Apt. 306,,,,,,,,,Canada,CA,BC,Langley,Google search,www.google.ca/
408,1/17/20 2:27am,Bandcamp,album,Music from Saharan WhatsApp,Etran de L'Aïr,USD,3.0,1.0,,3.0,,,,0.23,paypal,3.0,0.0,4034091047,,0.3,0.3,0.0,2.47,599.7,2.47,digital download,,http://etrandelair.bandcamp.com/album/music-from-saharan-whatsapp,,WHATSAPP-01,,,Jean Miller,pjennings@dickson.info,826-689-3182x088,,Meredith Montgomery,895 Mary Forge,,,,,,,,,Canada,CA,MB,Winnipeg,Publish notice sent to your fans,
409,1/17/20 2:36am,Bandcamp,album,Music from Saharan WhatsApp,Etran de L'Aïr,USD,9.99,1.0,,9.99,,,,0.49,paypal,9.99,0.0,2961941659,,1.0,1.0,0.0,8.5,608.2,8.5,digital download,,http://etrandelair.bandcamp.com/album/music-from-saharan-whatsapp,,WHATSAPP-01,,,Lauren Hill,kevin55@gmail.com,001-341-956-0619x97540,,Jennifer Daniels,7128 Courtney Mount Apt. 592,,,,,,,,,United States,US,RI,Providence,,
410,1/17/20 2:44am,Bandcamp,album,Music from Saharan WhatsApp,Etran de L'Aïr,USD,10.0,1.0,,10.0,,,,0.49,paypal,10.0,0.0,537934665,,1.0,1.0,0.0,8.51,616.71,8.51,digital download,,http://etrandelair.bandcamp.com/album/music-from-saharan-whatsapp,,WHATSAPP-01,,,Leonard Wallace,jcastillo@gmail.com,164.861.0461,,Janet Norris,36807 Jordan Ville Apt. 141,,,,,,,,,United States,US,AZ,Glendale,Google search,www.google.com/
411,1/17/20 3:04am,Bandcamp,album,Ilana: The Creator,Mdou Moctar,USD,7.0,1.0,,7.0,,,,0.76,credit card,7.0,0.0,1044051321,,0.7,0.0,0.7,0.0,616.71,5.54,digital download,,http://mdoumoctar.bandcamp.com/album/ilana-the-creator,,SS-051,602318 136893,,Jamie Brooks,lstewart@jones.com,001-393-243-8102x73356,,David Little,089 Kemp Gardens,,,,,,,,,United States,US,WI,Madison,,
412,1/17/20 3:04am,Bandcamp,album,Sousoume Tamachek,Mdou Moctar,USD,7.0,1.0,,7.0,,,,,,7.0,0.0,1044051321,,0.7,0.0,1.4,0.0,616.71,6.3,digital download,,http://mdoumoctar.bandcamp.com/album/sousoume-tamachek,,SS-043,191515 769435,,Jamie Brooks,sharon98@brennan-alvarez.com,001-250-206-7604x817,,Shane Ryan,428 Thomas Rapids,,,,,,,,,United States,US,WI,Madison,Bandcamp artist: mdoumoctar,mdoumoctar.bandcamp.com
413,1/17/20 3:04am,Bandcamp,album,Akounak Tedalat Taha Tazoughai OST,Mdou Moctar,USD,7.0,1.0,,7.0,,,,,,7.0,0.0,1044051321,,0.7,2.1,0.0,18.14,634.85,6.3,digital download,,http://mdoumoctar.bandcamp.com/album/akounak-tedalat-taha-tazoughai-ost,,SS-028,889326 667599,,Jamie Brooks,msanchez@hotmail.com,921-410-0971x592,,Michelle Le,90601 Heather Trace,,,,,,,,,United States,US,WI,Madison,Bandcamp artist: mdoumoctar,mdoumoctar.bandcamp.com
414,1/17/20 3:41am,Bandcamp,package,Ilana: The Creator,Mdou Moctar,USD,17.0,1.0,,17.0,,5.0,United States,0.94,gift card,22.0,0.0,3768036978,,1.7,1.7,0.0,19.36,654.21,14.36,Ilana LP,,http://mdoumoctar.bandcamp.com/album/ilana-the-creator,SS-051lp,SS-051,602318 136893,,Gregory Price,robinkirk@hotmail.com,049-434-4270x73281,,Shelley Cooper,844 Todd Manors Suite 368,,Chicago,IL,60640,United States,US,1/21/20,,United States,US,IL,Chicago,Bandcamp fan wishlist,bandcamp.com/davewillpark
415,1/17/20 3:47am,Bandcamp,album,Music from Saharan WhatsApp,Etran de L'Aïr,USD,1.0,1.0,,1.0,,,,0.11,paypal,1.0,0.0,2561485287,,0.1,0.1,0.0,0.79,655.0,0.79,digital download,,http://etrandelair.bandcamp.com/album/music-from-saharan-whatsapp,,WHATSAPP-01,,,Jared Brown,daniel67@gmail.com,130-801-4883,,Mark King,71879 Michelle Forest,,,,,,,,,Australia,AU,VIC,Hawthorn,,
416,1/17/20 5:38am,Bandcamp,album,Sahel Sounds Label Sampler,Various Artists,USD,1.0,1.0,,1.0,,,,0.1,paypal,1.0,0.0,3489919150,,0.1,0.1,0.0,0.8,655.8,0.8,digital download,,http://sahelsounds.bandcamp.com/album/sahel-sounds-label-sampler,,SS-058,602318 137111,,Melvin Oneal,leewells@york.com,+1-848-870-1537x6072,,Amber Bryan,391 Andrea Circle,,,,,,,,,United States,US,CO,Delta,Bandcamp app fan collection: jewelley,bandcamp.com/jewelley
417,1/17/20 6:16am,Bandcamp,album,Music from Saharan WhatsApp,Etran de L'Aïr,USD,5.0,1.0,,5.0,,,,0.3,paypal,5.0,0.0,4192244902,,0.5,0.5,0.0,4.2,660.0,4.2,digital download,,http://etrandelair.bandcamp.com/album/music-from-saharan-whatsapp,,WHATSAPP-01,,,Lisa Pennington,mccoyerik@rodgers-miranda.biz,(617)930-7443x6391,,Dennis Gray,13119 Daniel Highway Suite 787,,,,,,,,,United States,US,CA,San Mateo,Google search,www.google.com/
418,1/17/20 6:39am,Bandcamp,album,Music from Saharan Cellphones,Various,USD,8.0,1.0,,8.0,1.33,,,0.57,paypal,9.33,0.0,4092740379,,0.8,0.8,0.0,6.63,666.63,6.63,digital download,,http://sahelsounds.bandcamp.com/album/music-from-saharan-cellphones,,SS-003,889326 667889,,Denise Gordon,chapmanduane@gmail.com,+1-190-743-2642x9241,,Bradley Mills,08793 Mary Turnpike,,,,,,,,,Germany,DE,Mecklenburg-Vorpommern,Rostock,,
419,1/17/20 6:42am,Bandcamp,album,Music from Saharan WhatsApp,Etran de L'Aïr,USD,5.0,1.0,,5.0,,,,0.3,paypal,5.0,0.0,1437771638,,0.5,0.5,0.0,4.2,670.83,4.2,digital download,,http://etrandelair.bandcamp.com/album/music-from-saharan-whatsapp,,WHATSAPP-01,,,Gregory Castro,kevinmcdaniel@yahoo.com,(378)004-3326x02618,,Logan Parker,761 Brad Roads Apt. 971,,,,,,,,,United States,US,WA,Tacoma,Bandcamp fan wishlist,bandcamp.com/isaacolson
420,1/17/20 6:57am,Bandcamp,album,Music from Saharan WhatsApp,Etran de L'Aïr,USD,1.0,1.0,,1.0,,,,0.1,paypal,1.0,0.0,2026933028,,0.1,0.1,0.0,0.8,671.63,0.8,digital download,,http://etrandelair.bandcamp.com/album/music-from-saharan-whatsapp,,WHATSAPP-01,,,Lindsay Valdez,yschultz@hotmail.com,001-784-756-9712,,Benjamin Woodard,4633 Matthew Loaf Apt. 815,,,,,,,,,United States,US,CA,Menlo Park,Publish notice sent to your fans,
421,1/17/20 10:36am,Bandcamp,package,Les Filles de Illighadad,Les Filles de Illighadad,USD,20.0,1.0,,20.0,,5.0,United States,0.78,paypal,25.0,0.0,749035308,,2.0,2.0,0.0,22.22,693.85,17.22,Les Filles de Illighadad LP,,http://lesfillesdeillighadad.bandcamp.com/album/les-filles-de-illighadad,SS-033-LP,SS-033,889326 664918,,Lawrence Ryan,zacharyhill@griffin.net,123.451.5968x339,"Thank you! Gardo Ramirez Alhambra, California",Heather Love,9414 Michael Burg Apt. 314,,Alhambra,CA,91801,United States,US,1/21/20,,United States,US,CA,Alhambra,,
422,1/17/20 10:39am,Bandcamp,package,Eghass Malan,Les Filles de Illighadad,USD,20.0,1.0,,20.0,,5.0,United States,0.78,paypal,25.0,0.0,1277697875,,2.0,2.0,0.0,22.22,716.07,17.22,'Eghass Malan' LP,,http://lesfillesdeillighadad.bandcamp.com/album/eghass-malan,SS-044lp-1,SS-044,191515 928351,,Lawrence Ryan,wendywilliamson@gmail.com,5168622358,,Nicholas Hunter,2390 James Burg,,Alhambra,CA,91801,United States,US,1/21/20,,United States,US,CA,Alhambra,bandcamp.com,bandcamp.com
423,1/17/20 12:45pm,Bandcamp,album,Music from Saharan WhatsApp,Etran de L'Aïr,USD,5.0,1.0,,5.0,,,,0.35,paypal,5.0,0.0,3043147823,,0.5,0.5,0.0,4.15,720.22,4.15,digital download,,http://etrandelair.bandcamp.com/album/music-from-saharan-whatsapp,,WHATSAPP-01,,,Steven Morrison,hbush@dixon.net,001-051-634-3646,,Stephanie Alexander,28906 Combs Cliff Apt. 396,,,,,,,,,United Kingdom,GB,Southwark,Dulwich,Facebook,www.facebook.com
424,1/17/20 12:57pm,Bandcamp,album,Eghass Malan,Les Filles de Illighadad,USD,7.0,1.0,,7.0,1.61,,,0.55,paypal,8.61,0.0,1100926667,,0.7,0.7,0.0,5.75,725.97,5.75,digital download,,http://lesfillesdeillighadad.bandcamp.com/album/eghass-malan,,SS-044,191515 928351,,Melanie Marshall,melissa11@bates.com,160.772.7126x71048,,Shawn Proctor,062 Simmons Circle,,,,,,,,,Portugal,PT,Lisbon,Lisbon,Google search,www.google.com/
425,1/17/20 2:30pm,Bandcamp,album,Music from Saharan WhatsApp,Etran de L'Aïr,USD,5.0,1.0,,5.0,,,,0.3,credit card,5.0,0.0,3154350083,,0.5,0.5,0.0,4.2,730.17,4.2,digital download,,http://etrandelair.bandcamp.com/album/music-from-saharan-whatsapp,,WHATSAPP-01,,,Tyler Smith,burgesschristina@williams.com,612-841-7696x6990,,Tyler Jacobs,43219 Mann Mission Apt. 847,,,,,,,,,United States,US,NJ,Princeton,Bandcamp search,bandcamp.com/app/android/search
426,1/17/20 2:44pm,Bandcamp,package,Ilana: The Creator,Mdou Moctar,USD,17.0,1.0,,17.0,,5.0,United States,0.72,paypal,22.0,0.0,798254954,,1.7,1.7,0.0,19.58,749.75,14.58,Ilana LP,,http://mdoumoctar.bandcamp.com/album/ilana-the-creator,SS-051lp,SS-051,602318 136893,,Danielle Copeland,carrie91@gmail.com,764.103.6888x662,,Katherine Anderson,88979 Davis Grove Suite 560,,Harrisville,UT,84414,United States,US,1/21/20,,United States,US,UT,Harrisville,Bandcamp search,bandcamp.com/app/android/search
427,1/17/20 3:13pm,Bandcamp,package,Eghass Malan,Les Filles de Illighadad,USD,17.0,1.0,,17.0,,5.0,United States,0.72,paypal,22.0,0.0,1657310320,,1.7,1.7,0.0,19.58,769.33,14.58,'Eghass Malan' LP,,http://lesfillesdeillighadad.bandcamp.com/album/eghass-malan,SS-044lp-1,SS-044,191515 928351,,Kristina Obrien,paul64@hodge.com,792-020-1631x4954,,Virginia Quinn,1413 Cisneros Haven,,Ambler,PA,19002,United States,US,1/21/20,,United States,US,PA,Ambler,,
428,1/17/20 3:46pm,Bandcamp,album,Eghass Malan,Les Filles de Illighadad,USD,7.0,1.0,,7.0,,,,0.4,credit card,7.0,0.0,1917799165,,0.7,0.7,0.0,5.9,775.23,5.9,digital download,,http://lesfillesdeillighadad.bandcamp.com/album/eghass-malan,,SS-044,191515 928351,,Erica Cooper,walterjeffery@gmail.com,169-721-3482x91992,,Emily Fox,51719 Klein Mountain,,,,,,,,,United States,US,VT,Pawlet,Bandcamp artist recommendation: mrairplaneman,bandcamp.com/recommended/mrairplaneman
429,1/17/20 3:49pm,Bandcamp,album,Music from Saharan WhatsApp,Etran de L'Aïr,USD,2.0,1.0,,2.0,,,,0.17,paypal,2.0,0.0,1246595383,,0.2,0.2,0.0,1.63,776.86,1.63,digital download,,http://etrandelair.bandcamp.com/album/music-from-saharan-whatsapp,,WHATSAPP-01,,,Cassandra Camacho,michael64@gmail.com,+1-544-139-3757x119,,Kristopher Benson,9693 Guerra Spur,,,,,,,,,United Kingdom,GB,,,Bandcamp release notification: music feed,http://blog.bandcamp.com/2014/01/30/bandcamp-app-now-with-music-feed/
430,1/17/20 3:57pm,Bandcamp,album,Music from Saharan WhatsApp,Etran de L'Aïr,USD,5.0,1.0,,5.0,,,,0.3,paypal,5.0,0.0,3930118926,,0.5,0.5,0.0,4.2,781.06,4.2,digital download,,http://etrandelair.bandcamp.com/album/music-from-saharan-whatsapp,,WHATSAPP-01,,,Jean Elliott,dylan77@murphy.info,+1-397-045-7556x4381,,Kelli Brooks,97388 Peterson Ports,,,,,,,,,United States,US,CA,Los Angeles,Bandcamp fan activity email,bandcamp.com
431,1/17/20 4:05pm,Bandcamp,album,Music from Saharan WhatsApp,Etran de L'Aïr,USD,5.0,1.0,,5.0,,,,0.35,paypal,5.0,0.0,306587903,,0.5,0.5,0.0,4.15,785.21,4.15,digital download,,http://etrandelair.bandcamp.com/album/music-from-saharan-whatsapp,,WHATSAPP-01,,,Edward Caldwell,marshalljennifer@yahoo.com,748.565.4119x459,,David Ramirez,664 Howell Field Apt. 259,,,,,,,,,United Kingdom,GB,Manchester,Manchester,Bandcamp New & Notable,bandcamp.com/#new-notable
432,1/17/20 4:27pm,Bandcamp,album,Music from Saharan WhatsApp,Etran de L'Aïr,USD,4.0,1.0,,4.0,,,,0.25,credit card,4.0,0.0,929327446,,0.4,0.4,0.0,3.35,788.56,3.35,digital download,,http://etrandelair.bandcamp.com/album/music-from-saharan-whatsapp,,WHATSAPP-01,,,Heather Bridges,tonyareid@webb.com,+1-903-470-4114,,Karen Small,12090 Henry Knolls Suite 367,,,,,,,,,Greece,GR,Attica,Athens,Publish notice sent to your fans,
433,1/17/20 4:38pm,Bandcamp,album,Music from Saharan WhatsApp,Etran de L'Aïr,USD,3.0,1.0,,3.0,,,,0.23,paypal,3.0,0.0,2345787666,,0.3,0.3,0.0,2.47,791.03,2.47,digital download,,http://etrandelair.bandcamp.com/album/music-from-saharan-whatsapp,,WHATSAPP-01,,,Carol Allen,brandy37@lee.net,171-438-7860,,Joseph Lynch,780 Hanna Views,,,,,,,,,Canada,CA,BC,Vancouver,Bandcamp Discover,bandcamp.com/#discover
434,1/17/20 5:04pm,Bandcamp,album,Music from Saharan WhatsApp,Etran de L'Aïr,USD,3.0,1.0,,3.0,,,,0.2,paypal,3.0,0.0,3168255740,,0.3,0.3,0.0,2.5,793.53,2.5,digital download,,http://etrandelair.bandcamp.com/album/music-from-saharan-whatsapp,,WHATSAPP-01,,,Christopher Parker,davisharry@gmail.com,8074667559,,Kathleen Harrell,8682 Pena Rapids,,,,,,,,,United States,US,NC,Charlotte,Bandcamp music feed,http://blog.bandcamp.com/2014/01/30/bandcamp-app-now-with-music-feed/
435,1/17/20 5:23pm,Bandcamp,album,Ilana: The Creator,Mdou Moctar,USD,7.0,1.0,,7.0,1.33,,,0.54,paypal,8.33,0.0,320701574,,0.7,0.7,0.0,5.76,799.29,5.76,digital download,,http://mdoumoctar.bandcamp.com/album/ilana-the-creator,,SS-051,602318 136893,,Jesse Williams,jbrock@smith.com,(457)156-2073,,Veronica Campos,045 Leslie Highway,,,,,,,,,Germany,DE,Hesse,Frankfurt am Main,Bandcamp: spacecowgirl/following/artists_and_labels,bandcamp.com/spacecowgirl/following/artists_and_labels
436,1/17/20 5:44pm,Bandcamp,album,Music from Saharan WhatsApp,Etran de L'Aïr,USD,10.0,1.0,,10.0,,,,0.49,paypal,10.0,0.0,424007569,,1.0,1.0,0.0,8.51,807.8,8.51,digital download,,http://etrandelair.bandcamp.com/album/music-from-saharan-whatsapp,,WHATSAPP-01,,,Ashley Taylor,michaelcrawford@yahoo.com,095-838-7407x3214,,Rebecca Long,7809 Nancy Landing,,,,,,,,,United States,US,TX,Marfa,Google search,www.google.com/
437,1/17/20 6:02pm,shop@sahelsounds.com,payout,,,USD,,,,,,,,2.21,transfer,220.55,218.34,t251965977,3ER78854491565924,,,,-220.55,587.25,,,,,,,,,,,,,,,,,,,,,,,,,,,,
438,1/17/20 6:02pm,shop@sahelsounds.com,payout,,,USD,,,,,,,,2.21,transfer,221.23,219.02,t251965979,82P15529AV610773R,,,,-221.23,366.02,,,,,,,,,,,,,,,,,,,,,,,,,,,,
439,1/17/20 6:33pm,Bandcamp,album,Music from Saharan WhatsApp,Etran de L'Aïr,USD,5.0,1.0,,5.0,,,,0.35,credit card,5.0,0.0,2680944583,,0.5,0.5,0.0,4.15,370.17,4.15,digital download,,http://etrandelair.bandcamp.com/album/music-from-saharan-whatsapp,,WHATSAPP-01,,,Rebecca Walker,john16@hotmail.com,+1-376-229-2474,,Lynn Tran,149 Robert Fall Apt. 180,,,,,,,,,United Kingdom,GB,Gateshead,Gateshead,Publish notice sent to your fans,
440,1/17/20 6:44pm,Bandcamp,album,Music from Saharan WhatsApp,Etran de L'Aïr,USD,1.0,1.0,,1.0,,,,0.11,credit card,1.0,0.0,1044997376,,0.1,0.1,0.0,0.79,370.96,0.79,digital download,,http://etrandelair.bandcamp.com/album/music-from-saharan-whatsapp,,WHATSAPP-01,,,Connie Simmons,amy28@gmail.com,9448134249,,Victoria Perkins,601 Natalie Unions,,,,,,,,,United Kingdom,GB,,,Publish notice sent to your fans,
441,1/17/20 7:16pm,Bandcamp,album,Music from Saharan Cellphones,Various,USD,7.0,1.0,,7.0,,,,0.4,paypal,7.0,0.0,3986978175,,0.7,0.7,0.0,5.9,376.86,5.9,digital download,,http://sahelsounds.bandcamp.com/album/music-from-saharan-cellphones,,SS-003,889326 667889,,Danny Fleming,dianevelasquez@yahoo.com,519.559.5777x54913,,Wendy Ward,746 Linda Rapid Apt. 723,,,,,,,,,United States,US,CA,San Francisco,tumblr.com,www.tumblr.com/
442,1/17/20 7:29pm,Bandcamp,album,Music from Saharan WhatsApp,Etran de L'Aïr,USD,8.0,1.0,,8.0,,,,0.45,paypal,8.0,0.0,754647008,,0.8,0.8,0.0,6.75,383.61,6.75,digital download,,http://etrandelair.bandcamp.com/album/music-from-saharan-whatsapp,,WHATSAPP-01,,,Charles White,bbryan@walker.com,(290)356-0919,,Becky Gardner,74823 Figueroa Corner Suite 431,,,,,,,,,United States,US,WI,Milwaukee,Google search,www.google.com/
443,1/17/20 8:01pm,Bandcamp,album,Music from Saharan WhatsApp,Etran de L'Aïr,USD,6.0,1.0,,6.0,,,,0.35,paypal,6.0,0.0,4213380022,,0.6,0.6,0.0,5.05,388.66,5.05,digital download,,http://etrandelair.bandcamp.com/album/music-from-saharan-whatsapp,,WHATSAPP-01,,,Laura Nelson,donnajohnson@yahoo.com,+1-851-576-8098x0760,,Christy Moore,8631 Tyrone Shoal Apt. 822,,,,,,,,,United States,US,HI,Honolulu,Publish notice sent to your fans,
444,1/17/20 8:24pm,Bandcamp,package,Ilana: The Creator,Mdou Moctar,USD,17.0,1.0,,17.0,,5.0,United States,0.78,credit card,22.0,0.0,3574610853,,1.7,1.7,0.0,19.52,408.18,14.52,Ilana LP,,http://mdoumoctar.bandcamp.com/album/ilana-the-creator,SS-051lp,SS-051,602318 136893,,Connie Carter,jessicabyrd@romero.com,789-235-4075x2004,,Stacey Green,36821 Moore Manor,,Corvallis,OR,97333,United States,US,1/21/20,,United States,US,OR,Corvallis,,
445,1/17/20 9:08pm,Bandcamp,album,Music from Saharan WhatsApp,Etran de L'Aïr,USD,5.0,1.0,,5.0,,,,0.35,paypal,5.0,0.0,626258539,,0.5,0.5,0.0,4.15,412.33,4.15,digital download,,http://etrandelair.bandcamp.com/album/music-from-saharan-whatsapp,,WHATSAPP-01,,,Michael Terry,jill76@yahoo.com,(825)942-8013,,Maria Bishop,70892 John Mount,,,,,,,,,United Kingdom,GB,Greenwich,Greenwich,,
446,1/17/20 9:25pm,Bandcamp,album,Music from Saharan WhatsApp,Etran de L'Aïr,USD,5.0,1.0,,5.0,,,,0.35,paypal,5.0,0.0,2281697599,,0.5,0.5,0.0,4.15,416.48,4.15,digital download,,http://etrandelair.bandcamp.com/album/music-from-saharan-whatsapp,,WHATSAPP-01,,,Andrew Gallagher,mitchelljulie@yahoo.com,763.191.8127x12102,,Christina Walton,79030 Anthony Passage Suite 770,,,,,,,,,United Kingdom,GB,Glasgow City,Glasgow,l.instagram.com,l.instagram.com/
447,1/17/20 9:38pm,Bandcamp,album,Ilana: The Creator,Mdou Moctar,USD,10.0,1.0,,10.0,,,,0.62,credit card,10.0,0.0,3736281506,,1.0,1.0,0.0,8.38,424.86,8.38,digital download,,http://mdoumoctar.bandcamp.com/album/ilana-the-creator,,SS-051,602318 136893,,Tracey Bright,yferguson@hotmail.com,438.325.2997x86023,,Cameron Garcia,08590 Hubbard Forges Apt. 595,,,,,,,,,Jordan,JO,Amman Governorate,Amman,Google search,www.google.com/
448,1/17/20 9:44pm,Bandcamp,album,Music from Saharan WhatsApp,Etran de L'Aïr,USD,5.0,1.0,,5.0,,,,0.35,paypal,5.0,0.0,509389443,,0.5,0.5,0.0,4.15,429.01,4.15,digital download,,http://etrandelair.bandcamp.com/album/music-from-saharan-whatsapp,,WHATSAPP-01,,,Emily Sharp,elizabeth10@hotmail.com,(733)975-5244x51469,,Ryan Michael,95318 Sean Circles,,,,,,,,,Australia,AU,NSW,Sydney,Bandcamp weekly newsletter,bandcamp.com
449,1/17/20 10:11pm,Bandcamp,album,Music from Saharan Cellphones,Various,USD,10.0,1.0,,10.0,,,,0.49,paypal,10.0,0.0,3667469978,,1.0,1.0,0.0,8.51,437.52,8.51,digital download,,http://sahelsounds.bandcamp.com/album/music-from-saharan-cellphones,,SS-003,889326 667889,,Laura Williams,andrewreilly@yahoo.com,+1-588-490-6223x8534,,Amber Jackson,7219 Stephens Meadow Apt. 545,,,,,,,,,United States,US,IA,Iowa City,t.umblr.com,t.umblr.com/
450,1/17/20 10:23pm,Bandcamp,album,Music from Saharan WhatsApp,Etran de L'Aïr,USD,3.0,1.0,,3.0,,,,0.23,paypal,3.0,0.0,524798700,,0.3,0.3,0.0,2.47,439.99,2.47,digital download,,http://etrandelair.bandcamp.com/album/music-from-saharan-whatsapp,,WHATSAPP-01,,,Jared Goodwin,beckerjoseph@brown.com,(052)255-6201,,Corey Hunter,278 Danielle Spur Suite 864,,,,,,,,,United Kingdom,GB,Southwark,Nunhead,Bandcamp search,bandcamp.com/app/android/search
451,1/18/20 12:19am,Bandcamp,album,Music from Saharan WhatsApp,Etran de L'Aïr,USD,2.0,1.0,,2.0,,,,0.17,paypal,2.0,0.0,3956310723,,0.2,0.2,0.0,1.63,441.62,1.63,digital download,,http://etrandelair.bandcamp.com/album/music-from-saharan-whatsapp,,WHATSAPP-01,,,Stacy Washington,marshalljeffrey@hotmail.com,0507819439,,Luis Martin,0024 Martinez Oval Apt. 176,,,,,,,,,Australia,AU,NSW,Sydney,,
452,1/18/20 12:33am,Bandcamp,album,Music from Saharan WhatsApp,Etran de L'Aïr,USD,1.0,1.0,,1.0,,,,0.1,credit card,1.0,0.0,3460816953,,0.1,0.1,0.0,0.8,442.42,0.8,digital download,,http://etrandelair.bandcamp.com/album/music-from-saharan-whatsapp,,WHATSAPP-01,,,Peter Williams,dana65@yahoo.com,001-609-197-5165x12765,,Sarah Walters,46632 Vega Parks,,,,,,,,,United States,US,ME,Falmouth,Publish notice sent to your fans,
453,1/18/20 1:13am,Bandcamp,album,Music from Saharan WhatsApp,Etran de L'Aïr,USD,1.0,1.0,,1.0,,,,0.1,paypal,1.0,0.0,1773421451,,0.1,0.1,0.0,0.8,443.22,0.8,digital download,,http://etrandelair.bandcamp.com/album/music-from-saharan-whatsapp,,WHATSAPP-01,,,Daniel Thomas,smeza@mckinney.com,125-043-9823x239,,Sheryl Horton,5315 Crystal Glen,,,,,,,,,United States,US,FL,Windermere,,
454,1/18/20 3:51am,Bandcamp,album,Music from Saharan WhatsApp,Etran de L'Aïr,USD,5.0,1.0,,5.0,,,,0.3,paypal,5.0,0.0,1245330479,,0.5,0.5,0.0,4.2,447.42,4.2,digital download,,http://etrandelair.bandcamp.com/album/music-from-saharan-whatsapp,,WHATSAPP-01,,,Gabriela Sanchez,james02@hotmail.com,(274)440-7711x3647,,Annette Jones,614 Eric Trail,,,,,,,,,United States,US,IL,Oak Park,Twitter,t.co/qvf0Q5hRhg?amp=1
455,1/18/20 4:19am,Bandcamp,album,Music from Saharan WhatsApp,Etran de L'Aïr,USD,1.0,1.0,,1.0,,,,0.1,credit card,1.0,0.0,3879831077,,0.1,0.1,0.0,0.8,448.22,0.8,digital download,,http://etrandelair.bandcamp.com/album/music-from-saharan-whatsapp,,WHATSAPP-01,,,Katie Fernandez,garciaaaron@hale.biz,(856)278-9930,,Ronnie Hartman,9236 Fischer Trace Apt. 080,,,,,,,,,United States,US,MN,Minneapolis,Bandcamp weekly newsletter,bandcamp.com
456,1/18/20 5:25am,Bandcamp,album,Music from Saharan WhatsApp,Etran de L'Aïr,USD,3.0,1.0,,3.0,,,,0.23,credit card,3.0,0.0,614203187,,0.3,0.3,0.0,2.47,450.69,2.47,digital download,,http://etrandelair.bandcamp.com/album/music-from-saharan-whatsapp,,WHATSAPP-01,,,Jonathan Sanchez,rzimmerman@gmail.com,189-292-6923,,Jeanette Harmon,734 White Fort,,,,,,,,,New Zealand,NZ,Canterbury,Christchurch,Publish notice sent to your fans,
457,1/18/20 5:45am,Bandcamp,album,Music from Saharan WhatsApp,Etran de L'Aïr,USD,2.0,1.0,,2.0,,,,0.15,credit card,2.0,0.0,3725687492,,0.2,0.2,0.0,1.65,452.34,1.65,digital download,,http://etrandelair.bandcamp.com/album/music-from-saharan-whatsapp,,WHATSAPP-01,,,Brad Kim,cbenson@jones-cunningham.com,097-892-0647x700,,Jessica Morgan,491 Damon Cove,,,,,,,,,United States,US,CO,Lafayette,Publish notice sent to your fans,
458,1/18/20 6:39am,Bandcamp,album,Music from Saharan WhatsApp,Etran de L'Aïr,USD,3.0,1.0,,3.0,,,,0.23,credit card,3.0,0.0,2138515921,,0.3,0.3,0.0,2.47,454.81,2.47,digital download,,http://etrandelair.bandcamp.com/album/music-from-saharan-whatsapp,,WHATSAPP-01,,,Eric Dickerson,michelle81@mcdonald-carey.com,363-818-0270,,Valerie Gonzalez,02113 Bean Course,,,,,,,,,United Kingdom,GB,Hertfordshire,St Albans,Publish notice sent to your fans,
459,1/18/20 7:34am,Bandcamp,album,Music from Saharan WhatsApp,Etran de L'Aïr,USD,4.0,1.0,,4.0,,,,0.29,credit card,4.0,0.0,4049721785,,0.4,0.4,0.0,3.31,458.12,3.31,digital download,,http://etrandelair.bandcamp.com/album/music-from-saharan-whatsapp,,WHATSAPP-01,,,Michael Johnson,lanesteven@gmail.com,652.809.7737,,Jenna Anderson,4152 Ronald Parks,,,,,,,,,Australia,AU,NSW,Newtown,Bandcamp search,bandcamp.com/autocomplete-search
460,1/18/20 10:03am,Bandcamp,album,Music from Saharan WhatsApp,Etran de L'Aïr,USD,1.0,1.0,,1.0,,,,0.11,paypal,1.0,0.0,80980456,,0.1,0.1,0.0,0.79,458.91,0.79,digital download,,http://etrandelair.bandcamp.com/album/music-from-saharan-whatsapp,,WHATSAPP-01,,,Mitchell Fernandez,rebeccaalvarado@shaw-henderson.com,108-601-2008,,Anthony Page,323 Cheryl Center,,,,,,,,,Germany,DE,Land Berlin,Berlin,Bandcamp artist: etrandelair,etrandelair.bandcamp.com/album/music-from-saharan-whatsapp
461,1/18/20 10:08am,Bandcamp,album,Music from Saharan WhatsApp,Etran de L'Aïr,USD,3.0,1.0,,3.0,,,,0.23,paypal,3.0,0.0,1555049456,,0.3,0.3,0.0,2.47,461.38,2.47,digital download,,http://etrandelair.bandcamp.com/album/music-from-saharan-whatsapp,,WHATSAPP-01,,,Kathleen Allison,johnsonjacob@yates.com,001-552-352-4405x310,,Megan Dalton,356 Victoria Mall Apt. 783,,,,,,,,,United Kingdom,GB,England,London,Bandcamp search,bandcamp.com/app/android/search
462,1/18/20 10:32am,Bandcamp,package,Ilana: The Creator,Mdou Moctar,USD,17.0,1.0,,17.0,,5.0,United States,0.72,paypal,22.0,0.0,3363744542,,1.7,1.7,0.0,19.58,480.96,14.58,Ilana LP,,http://mdoumoctar.bandcamp.com/album/ilana-the-creator,SS-051lp,SS-051,602318 136893,,Alec Tanner,james81@shaw-patton.org,(055)656-6175,,Katherine Little,1941 Brandy Village,Apt A3,Seattle,WA,98117,United States,US,1/21/20,,United States,US,WA,Seattle,Google search,www.google.com/
463,1/18/20 10:44am,Bandcamp,album,La Musique Electronique du Niger,Mamman Sani,USD,15.0,1.0,,15.0,1.4,,,0.82,credit card,16.4,0.0,2217108838,,1.5,1.5,0.0,12.68,493.64,12.68,digital download,,http://mammansani.bandcamp.com/album/la-musique-electronique-du-niger,,SS-011,889326 664864,,Dale Mills,aaron84@yahoo.com,842-348-2666,,Ricardo Jones,134 Jennifer Tunnel Suite 456,,,,,,,,,France,FR,Seine-Saint-Denis,Livry-Gargan,Google search,www.google.com/
464,1/18/20 11:29am,Bandcamp,album,Music from Saharan WhatsApp,Etran de L'Aïr,USD,2.0,1.0,,2.0,,,,0.17,paypal,2.0,0.0,102521499,,0.2,0.2,0.0,1.63,495.27,1.63,digital download,,http://etrandelair.bandcamp.com/album/music-from-saharan-whatsapp,,WHATSAPP-01,,,James Knight,gshea@potter.com,(114)498-6435x148,,Craig Barker,2453 Emily Garden Suite 986,,,,,,,,,Canada,CA,ON,Whitby,Facebook,m.facebook.com
465,1/18/20 11:31am,Bandcamp,album,Music from Saharan WhatsApp,Etran de L'Aïr,USD,4.0,1.0,,4.0,,,,0.29,credit card,4.0,0.0,124800703,,0.4,0.4,0.0,3.31,498.58,3.31,digital download,,http://etrandelair.bandcamp.com/album/music-from-saharan-whatsapp,,WHATSAPP-01,,,Michael Wang,cdonaldson@walker.com,+1-274-593-1104,,Frank Davis,061 Chen Keys Apt. 741,,,,,,,,,Germany,DE,Land Berlin,Berlin,Facebook,www.facebook.com
466,1/18/20 3:22pm,Bandcamp,album,Falaw,Luka Productions,USD,7.0,1.0,,7.0,,,,0.4,paypal,7.0,0.0,2549925653,,0.7,0.7,0.0,5.9,504.48,5.9,digital download,,http://lukaproductions.bandcamp.com/album/falaw,,SS-052,602318 136855,,Patricia Davis,browndavid@gmail.com,575-027-2735x0494,,Debra Sanchez,6675 Karen Plaza Apt. 958,,,,,,,,,United States,US,CO,Denver,,
467,1/18/20 4:06pm,Bandcamp,album,Ilana: The Creator,Mdou Moctar,USD,7.0,1.0,,7.0,,,,0.4,paypal,7.0,0.0,923839998,,0.7,0.7,0.0,5.9,510.38,5.9,digital download,,http://mdoumoctar.bandcamp.com/album/ilana-the-creator,,SS-051,602318 136893,,Luis Shepherd,kcollins@hotmail.com,(049)023-0727x2287,,Melissa Oliver,0279 Brandon Keys,,,,,,,,,United States,US,CT,Storrs,Bandcamp search,bandcamp.com/app/ios/search
468,1/18/20 4:16pm,Bandcamp,album,Music from Saharan WhatsApp,Etran de L'Aïr,USD,2.0,1.0,,2.0,,,,0.17,credit card,2.0,0.0,3107198828,,0.2,0.2,0.0,1.63,512.01,1.63,digital download,,http://etrandelair.bandcamp.com/album/music-from-saharan-whatsapp,,WHATSAPP-01,,,Mario Sloan,david19@hotmail.com,559.504.7971x533,,Jeremy Johnson,97347 Wanda Brooks Apt. 964,,,,,,,,,Germany,DE,Land Berlin,Berlin,Bandcamp weekly newsletter,bandcamp.com
469,1/18/20 4:25pm,Bandcamp,album,Ilana: The Creator,Mdou Moctar,USD,7.0,1.0,,7.0,1.54,,,0.55,paypal,8.54,0.0,823739913,,0.7,0.7,0.0,5.75,517.76,5.75,digital download,,http://mdoumoctar.bandcamp.com/album/ilana-the-creator,,SS-051,602318 136893,,Virginia Casey,michellemayo@holloway.biz,001-768-032-9198x8603,,Cynthia Berry,771 Armstrong Rest Apt. 297,,,,,,,,,Italy,IT,Milan,Milan,Bandcamp search,bandcamp.com/app/android/search
470,1/18/20 4:35pm,Bandcamp,package,Taaritt,Mamman Sani,USD,17.0,1.0,,17.0,,5.0,United States,0.78,credit card,22.0,0.0,3559323595,,1.7,1.7,0.0,19.52,537.28,14.52,Taaritt LP,,http://mammansani.bandcamp.com/album/taaritt,SS-023lp,SS-023,889326 664871,,Nicole Ibarra,nancy06@yahoo.com,001-937-894-9825x18652,,Lisa Oconnor,837 Floyd Squares Suite 385,,New Orleans,LA,70115,United States,US,1/21/20,,United States,US,LA,New Orleans,,
471,1/18/20 4:57pm,Bandcamp,album,Music from Saharan WhatsApp,Etran de L'Aïr,USD,5.0,1.0,,5.0,,,,0.35,paypal,5.0,0.0,433826847,,0.5,0.5,0.0,4.15,541.43,4.15,digital download,,http://etrandelair.bandcamp.com/album/music-from-saharan-whatsapp,,WHATSAPP-01,,,James Graves,kelseylee@hotmail.com,(366)043-7308x81822,,Kevin Odom,5237 Osborne Creek Apt. 456,,,,,,,,,France,FR,Aisne,Saint-Quentin,Bandcamp weekly newsletter,bandcamp.com
472,1/18/20 5:10pm,Bandcamp,album,Music from Saharan Cellphones,Various,USD,10.0,1.0,,10.0,,,,0.59,paypal,10.0,0.0,94594041,,1.0,1.0,0.0,8.41,549.84,8.41,digital download,,http://sahelsounds.bandcamp.com/album/music-from-saharan-cellphones,,SS-003,889326 667889,,Sydney Cooper,brandonbarker@ray.com,887.933.3342,,Linda Santos,684 John Mountains,,,,,,,,,Maldives,MV,Kaafu Atoll,Malé,,
473,1/18/20 6:02pm,shop@sahelsounds.com,payout,,,USD,,,,,,,,0.91,transfer,91.39,90.48,t252229922,8BC81995N7513920B,,,,-91.39,458.45,,,,,,,,,,,,,,,,,,,,,,,,,,,,
474,1/18/20 6:02pm,shop@sahelsounds.com,payout,,,USD,,,,,,,,2.75,transfer,274.63,271.88,t252229923,7SS56868JC891305K,,,,-274.63,183.82,,,,,,,,,,,,,,,,,,,,,,,,,,,,
475,1/18/20 7:05pm,Bandcamp,album,Music from Saharan WhatsApp,Etran de L'Aïr,USD,5.0,1.0,,5.0,,,,0.3,gift card,5.0,0.0,2749636613,,0.5,0.5,0.0,4.2,188.02,4.2,digital download,,http://etrandelair.bandcamp.com/album/music-from-saharan-whatsapp,,WHATSAPP-01,,,Jacob Howard,dennissnow@yahoo.com,447.398.5051x4491,,Nathan Morrow,137 David Brook,,,,,,,,,United States,US,IL,Peoria,Facebook,www.facebook.com
476,1/18/20 8:56pm,Bandcamp,package,Ilana: The Creator,Mdou Moctar,USD,17.0,1.0,,17.0,,5.0,United States,0.72,paypal,22.0,0.0,2328603253,,1.7,1.7,0.0,19.58,207.6,14.58,Ilana LP,,http://mdoumoctar.bandcamp.com/album/ilana-the-creator,SS-051lp,SS-051,602318 136893,,James Davis,joseph14@hotmail.com,001-545-702-2943,,Lori Morris,522 Webb Gateway,,Vancouver,WA,98683,United States,US,1/21/20,,United States,US,WA,Vancouver,,
477,1/18/20 9:02pm,Bandcamp,album,Music from Saharan WhatsApp,Etran de L'Aïr,USD,1.0,1.0,,1.0,,,,0.11,paypal,1.0,0.0,474007087,,0.1,0.1,0.0,0.79,208.39,0.79,digital download,,http://etrandelair.bandcamp.com/album/music-from-saharan-whatsapp,,WHATSAPP-01,,,Mark Martin,kayla68@reese.com,(103)919-4129,,Alexander Peterson,4443 Samuel Prairie Suite 536,,,,,,,,,United Kingdom,GB,Glasgow City,Glasgow,Bandcamp release notification: music feed,http://blog.bandcamp.com/2014/01/30/bandcamp-app-now-with-music-feed/
478,1/18/20 10:20pm,Bandcamp,album,Field Recordings from the Sahel,Sahel Sounds,USD,1.0,1.0,,1.0,,,,0.11,credit card,1.0,0.0,1763226966,,0.1,0.1,0.0,0.79,209.18,0.79,digital download,,http://sahelsounds.bandcamp.com/album/field-recordings-from-the-sahel,,SS-057,602318 137104,,Alicia Buck,robertlucas@morris-bernard.com,(200)529-9890,,Kendra Floyd,6321 Aguirre Wall,,,,,,,,,United Kingdom,GB,Bromley,Beckenham,youtube.com,www.youtube.com/
479,1/18/20 10:36pm,Bandcamp,album,Sahel Sounds Label Sampler,Various Artists,USD,1.0,1.0,,1.0,,,,0.11,paypal,1.0,0.0,4251147559,,0.1,0.1,0.0,0.79,209.97,0.79,digital download,,http://sahelsounds.bandcamp.com/album/sahel-sounds-label-sampler,,SS-058,602318 137111,,Michelle Fuller,kimashley@gmail.com,232.271.2458,,Catherine Hudson,5213 Patrick Shoal Suite 770,,,,,,,,,United Kingdom,GB,Plymouth,Plymouth,Bandcamp search,bandcamp.com/app/android/search
480,1/18/20 10:59pm,Bandcamp,album,Ilana: The Creator,Mdou Moctar,USD,10.0,1.0,,10.0,,,,0.59,paypal,10.0,0.0,2767917121,,1.0,1.0,0.0,8.41,218.38,8.41,digital download,,http://mdoumoctar.bandcamp.com/album/ilana-the-creator,,SS-051,602318 136893,,John Armstrong,cole33@hotmail.com,313.105.5127,,Tricia Schwartz,09515 Pamela Inlet Apt. 597,,,,,,,,,Australia,AU,VIC,Doncaster East,Bandcamp fan page: oneoneone1,bandcamp.com/oneoneone1
481,1/19/20 1:50am,Bandcamp,album,Music from Saharan WhatsApp,Etran de L'Aïr,USD,4.0,1.0,,4.0,,,,0.65,credit card,4.0,0.0,3100908851,,0.4,0.0,0.4,0.0,218.38,2.95,digital download,,http://etrandelair.bandcamp.com/album/music-from-saharan-whatsapp,,WHATSAPP-01,,,Kathy Sloan,jeffrey41@hotmail.com,001-334-632-6351,,Christopher Ellis,91878 Sharon Passage Apt. 121,,,,,,,,,Australia,AU,NSW,Sydney,Bandcamp music feed: andrewleeson - summerbreeze1,http://blog.bandcamp.com/2013/09/19/strap-on-your-feed-bag/
482,1/19/20 1:50am,Bandcamp,album,No. 1,Etran de L'Aïr,USD,7.0,1.0,,7.0,,,,,,7.0,0.0,3100908851,,0.7,1.1,0.0,9.25,227.63,6.3,digital download,,http://etrandelair.bandcamp.com/album/no-1,,SS-045,602318 136824,,Kathy Sloan,harrisnicholas@evans.com,792.715.7552,,Timothy Estrada,04446 Williams Flat Apt. 708,,,,,,,,,Australia,AU,NSW,Sydney,Bandcamp music feed: andrewleeson - summerbreeze1,http://blog.bandcamp.com/2013/09/19/strap-on-your-feed-bag/
483,1/19/20 2:08am,Bandcamp,album,Music from Saharan WhatsApp,Etran de L'Aïr,USD,3.0,1.0,,3.0,,,,0.23,credit card,3.0,0.0,1217034981,,0.3,0.3,0.0,2.47,230.1,2.47,digital download,,http://etrandelair.bandcamp.com/album/music-from-saharan-whatsapp,,WHATSAPP-01,,,Blake Cobb,cartermary@kramer.com,001-393-428-7015,,Emily Douglas,1342 Austin Prairie Suite 494,,,,,,,,,Australia,AU,VIC,Melbourne,Bandcamp New & Notable,bandcamp.com/#new-notable
484,1/19/20 4:37am,Bandcamp,album,Houmeissa,Hama,USD,7.0,1.0,,7.0,,,,0.92,credit card,7.0,0.0,4089339748,,0.7,0.0,0.7,0.0,230.1,5.38,digital download,,http://hamasynth.bandcamp.com/album/houmeissa,,SS-049,656605 382364,,Leslie Sanchez,jkim@yahoo.com,271-765-6450x964,,Shannon Washington,13043 Robinson Key Apt. 800,,,,,,,,,United States,US,VT,Burlington,smarturl.it,smarturl.it/lukaproductions
485,1/19/20 4:37am,Bandcamp,album,Falaw,Luka Productions,USD,7.0,1.0,,7.0,,,,,,7.0,0.0,4089339748,,0.7,0.0,1.4,0.0,230.1,6.3,digital download,,http://lukaproductions.bandcamp.com/album/falaw,,SS-052,602318 136855,,Leslie Sanchez,kevinoliver@gonzalez.info,+1-938-822-9528,,Kelly Daniel,7508 Thomas Plaza Apt. 153,,,,,,,,,United States,US,VT,Burlington,,
486,1/19/20 4:37am,Bandcamp,album,Eghass Malan,Les Filles de Illighadad,USD,7.0,1.0,,7.0,,,,,,7.0,0.0,4089339748,,0.7,0.0,2.1,0.0,230.1,6.3,digital download,,http://lesfillesdeillighadad.bandcamp.com/album/eghass-malan,,SS-044,191515 928351,,Leslie Sanchez,chrishernandez@hotmail.com,+1-677-013-8880x975,,Cameron Taylor,51668 Felicia Pike,,,,,,,,,United States,US,VT,Burlington,smarturl.it,smarturl.it/lukaproductions
487,1/19/20 4:37am,Bandcamp,album,Les Filles de Illighadad,Les Filles de Illighadad,USD,7.0,1.0,,7.0,,,,,,7.0,0.0,4089339748,,0.7,2.8,0.0,24.28,254.38,6.3,digital download,,http://lesfillesdeillighadad.bandcamp.com/album/les-filles-de-illighadad,,SS-033,889326 664918,,Leslie Sanchez,micheal02@allen.com,179.610.0738x87390,,Mary Reeves,3218 Annette Stravenue Suite 463,,,,,,,,,United States,US,VT,Burlington,,
488,1/19/20 5:12am,Bandcamp,album,Music from Saharan Cellphones,Various,USD,10.0,1.0,,10.0,,,,0.52,credit card,10.0,0.0,2969221708,,1.0,1.0,0.0,8.48,262.86,8.48,digital download,,http://sahelsounds.bandcamp.com/album/music-from-saharan-cellphones,,SS-003,889326 667889,,Felicia Morgan,hwatkins@yahoo.com,001-958-605-4914,,David Thompson,11192 Savage Mountain,,,,,,,,,United States,US,MI,Ypsilanti,Google search,www.google.com/
489,1/19/20 7:13am,Bandcamp,album,Music from Saharan Cellphones,Various,USD,10.0,1.0,,10.0,,,,0.49,paypal,10.0,0.0,2207287759,,1.0,1.0,0.0,8.51,271.37,8.51,digital download,,http://sahelsounds.bandcamp.com/album/music-from-saharan-cellphones,,SS-003,889326 667889,,Kimberly Romero,parsonsrichard@cain.net,(311)304-8118x44347,,Amanda Chandler,85066 Steven Island,,,,,,,,,United States,US,TX,Alvin,tumblr.com,www.tumblr.com/
490,1/19/20 8:17am,Bandcamp,album,Music from Saharan WhatsApp,Etran de L'Aïr,USD,1.0,1.0,,1.0,,,,0.11,credit card,1.0,0.0,1381387220,,0.1,0.1,0.0,0.79,272.16,0.79,digital download,,http://etrandelair.bandcamp.com/album/music-from-saharan-whatsapp,,WHATSAPP-01,,,Wayne Jacobs,beth57@hotmail.com,013-601-0826x244,,Paul Jones,2264 Hunt Bridge,,,,,,,,,Luxembourg,LU,,,,
491,1/19/20 9:25am,Bandcamp,album,Music from Saharan WhatsApp,Etran de L'Aïr,USD,1.0,1.0,,1.0,,,,0.1,credit card,1.0,0.0,1248589429,,0.1,0.1,0.0,0.8,272.96,0.8,digital download,,http://etrandelair.bandcamp.com/album/music-from-saharan-whatsapp,,WHATSAPP-01,,,Nicholas Howe,hgoodman@gmail.com,463-422-7787,,Christopher Parks,334 Joseph Crossroad,,,,,,,,,United States,US,MO,St Louis,Bandcamp artist: sahelsounds,sahelsounds.bandcamp.com/album/sahel-sounds-label-sampler
492,1/19/20 10:25am,Bandcamp,album,Anou Malane,Abdallah Ag Oumbadougou,USD,8.0,1.0,,8.0,1.47,,,0.57,paypal,9.47,0.0,3654581689,,0.8,0.8,0.0,6.63,279.59,6.63,digital download,,http://abdallahagoumbadougou.bandcamp.com/album/anou-malane,,SS-053,602318 136992,,Alex Garrison,ashleyjackson@ellison-cole.com,379.126.7651x4874,,Scott Newton,96456 Benjamin Walks Apt. 596,,,,,,,,,Belgium,BE,Brussels Capital,Ixelles-Elsene,Facebook,m.facebook.com
493,1/19/20 1:39pm,Bandcamp,album,Eghass Malan,Les Filles de Illighadad,USD,7.0,1.0,,7.0,,,,0.57,paypal,7.0,0.0,2625960191,,0.7,0.0,0.7,0.0,279.59,5.73,digital download,,http://lesfillesdeillighadad.bandcamp.com/album/eghass-malan,,SS-044,191515 928351,,Erin Sherman,moniquethomas@hotmail.com,767-945-9581,,Jasmine Martin,437 Jennifer Shore Apt. 402,,,,,,,,,United States,US,IL,La Grange,,
494,1/19/20 1:39pm,Bandcamp,album,Les Filles de Illighadad,Les Filles de Illighadad,USD,7.0,1.0,,7.0,,,,,,7.0,0.0,2625960191,,0.7,1.4,0.0,12.03,291.62,6.3,digital download,,http://lesfillesdeillighadad.bandcamp.com/album/les-filles-de-illighadad,,SS-033,889326 664918,,Erin Sherman,nbrown@thompson.biz,528.946.4363x1138,,Terri Manning,3406 Spence Port Suite 894,,,,,,,,,United States,US,IL,La Grange,,
495,1/19/20 2:00pm,Bandcamp,album,Music from Saharan Cellphones,Various,USD,7.0,1.0,,7.0,,,,0.4,paypal,7.0,0.0,3756263521,,0.7,0.7,0.0,5.9,297.52,5.9,digital download,,http://sahelsounds.bandcamp.com/album/music-from-saharan-cellphones,,SS-003,889326 667889,,Misty Rhodes,shopkins@reynolds.info,(000)919-7143,,Eric Villegas,66147 Katherine Drive Suite 625,,,,,,,,,United States,US,NY,New York,,
496,1/19/20 2:20pm,Bandcamp,package,Zerzura (Original Soundtrack Recording),Ahmoudou Madassane,USD,15.0,1.0,,15.0,,10.0,United States,1.03,paypal,25.0,0.0,4057895280,,1.5,1.5,0.0,22.47,319.99,12.47,Zerzura DVD,,http://sahelsounds.bandcamp.com/merch/zerzura-dvd,SS-046DVD,,,,Rebecca Oconnell,jzhang@johnson.com,503.844.2388x15494,,Todd Gonzalez,732 Cross Forges,,Garching bei München,,85748,Germany,DE,1/21/20,,Germany,DE,,Garching bei München,,
497,1/19/20 2:24pm,Bandcamp,album,L'Orchestre National de Mauritanie - La Mone / Kamlat,L'Orchestre National de Mauritanie,USD,1.0,1.0,,1.0,,,,0.11,credit card,1.0,0.0,2219424014,,0.1,0.1,0.0,0.79,320.78,0.79,digital download,,http://lorchestrenationaldemauritanie.bandcamp.com/album/lorchestre-national-de-mauritanie-la-mone-kamlat,,SS-002,889326 664949,,Nicole Tyler,brianna47@hotmail.com,(085)524-3341,,Christopher Sutton,95512 Cox Mountain Suite 627,,,,,,,,,Belgium,BE,East Flanders Province,Ghent,Recommendations footer: artist recommendation,bandcamp.com/footer/ar/a95753531
498,1/19/20 4:03pm,Bandcamp,album,Music from Saharan WhatsApp,Etran de L'Aïr,USD,3.0,1.0,,3.0,,,,0.23,paypal,3.0,0.0,371483445,,0.3,0.3,0.0,2.47,323.25,2.47,digital download,,http://etrandelair.bandcamp.com/album/music-from-saharan-whatsapp,,WHATSAPP-01,,,Jennifer Whitaker,davidlopez@jenkins.com,011.614.8064x064,,Alex Newton,37159 Johnston Mountains Suite 820,,,,,,,,,Canada,CA,ON,Toronto,Facebook,www.facebook.com
499,1/19/20 5:30pm,Bandcamp,album,Music from Saharan WhatsApp,Etran de L'Aïr,USD,1.0,1.0,,1.0,,,,0.11,paypal,1.0,0.0,176183772,,0.1,0.1,0.0,0.79,324.04,0.79,digital download,,http://etrandelair.bandcamp.com/album/music-from-saharan-whatsapp,,WHATSAPP-01,,,Michelle Turner,catherine07@yahoo.com,842-142-5572,,Melissa Ramirez,56851 James Shores Apt. 530,,,,,,,,,United Kingdom,GB,Leeds,Leeds,Bandcamp music feed,http://blog.bandcamp.com/2014/01/30/bandcamp-app-now-with-music-feed/
500,1/19/20 5:45pm,Bandcamp,album,No. 1,Etran de L'Aïr,USD,7.0,1.0,,7.0,1.33,,,0.69,credit card,8.33,0.0,2372020473,,0.7,0.0,0.7,0.0,324.04,5.61,digital download,,http://etrandelair.bandcamp.com/album/no-1,,SS-045,602318 136824,,Kristin Fitzgerald,brendaburke@yahoo.com,+1-173-715-0796x7756,,Deborah Sanchez,3243 Lucero Gateway Suite 817,,,,,,,,,Germany,DE,North Rhine-Westphalia,Cologne,,
501,1/19/20 5:45pm,Bandcamp,album,Music from Saharan WhatsApp,Etran de L'Aïr,USD,4.0,1.0,,4.0,,,,,,4.0,0.0,2372020473,,0.4,1.1,0.0,9.21,333.25,3.6,digital download,,http://etrandelair.bandcamp.com/album/music-from-saharan-whatsapp,,WHATSAPP-01,,,Kristin Fitzgerald,elizabeth67@hotmail.com,085-123-9644x439,,Jacob Stevens,51327 Jordan Square,,,,,,,,,Germany,DE,North Rhine-Westphalia,Cologne,,
502,1/19/20 6:02pm,shop@sahelsounds.com,payout,,,USD,,,,,,,,1.02,transfer,102.35,101.33,t252455299,86658052XC270961M,,,,-102.35,230.9,,,,,,,,,,,,,,,,,,,,,,,,,,,,
503,1/19/20 6:02pm,shop@sahelsounds.com,payout,,,USD,,,,,,,,0.81,transfer,81.47,80.66,t252455281,0A4604825R306524G,,,,-81.47,149.43,,,,,,,,,,,,,,,,,,,,,,,,,,,,
504,1/19/20 7:13pm,Bandcamp,album,Music from Saharan WhatsApp,Etran de L'Aïr,USD,3.0,1.0,,3.0,,,,0.2,paypal,3.0,0.0,3986467016,,0.3,0.3,0.0,2.5,151.93,2.5,digital download,,http://etrandelair.bandcamp.com/album/music-from-saharan-whatsapp,,WHATSAPP-01,,,Evan Edwards,thomastracy@brown.com,(218)950-3558,,Nicole Li,288 Doyle Bypass Apt. 208,,,,,,,,,United States,US,CA,Sacramento,Bandcamp release notification: music feed,http://blog.bandcamp.com/2014/01/30/bandcamp-app-now-with-music-feed/
505,1/19/20 7:27pm,Bandcamp,album,Tiris,El Wali,USD,7.0,1.0,,7.0,1.4,,,0.57,credit card,8.4,0.0,4027406935,,0.7,0.7,0.0,5.73,157.66,5.73,digital download,,http://elwali.bandcamp.com/album/tiris,,SS-055,602318 136923,,Brittney Butler,mbridges@morris.com,+1-148-913-0801x4989,,Alexandra Nunez,0869 Medina Island Apt. 364,,,,,,,,,United Kingdom,GB,Haringey,Tottenham,Bandcamp search: “tiris”,bandcamp.com/search?q=tiris
506,1/19/20 9:57pm,Bandcamp,album,Music from Saharan WhatsApp,Etran de L'Aïr,USD,1.0,1.0,,1.0,,,,0.1,credit card,1.0,0.0,3595130071,,0.1,0.1,0.0,0.8,158.46,0.8,digital download,,http://etrandelair.bandcamp.com/album/music-from-saharan-whatsapp,,WHATSAPP-01,,,Jacob Diaz,allenronald@martin.com,001-767-444-9249x527,"Hello Etran de L'Air........your music is lovely and I am grateful to Sahel Sounds for making it available. I have a radio show here in the States and will be airing your EP. Thank you so much, and I wish you all the best. Mark Taylor",Pamela Morgan,482 Smith Vista Suite 529,,,,,,,,,United States,US,PA,Chadds Ford,,
507,1/19/20 10:30pm,Bandcamp,album,Music from Saharan WhatsApp,Etran de L'Aïr,USD,2.0,1.0,,2.0,,,,0.15,credit card,2.0,0.0,1174838642,,0.2,0.2,0.0,1.65,160.11,1.65,digital download,,http://etrandelair.bandcamp.com/album/music-from-saharan-whatsapp,,WHATSAPP-01,,,Jim Contreras,bartlettcolleen@yahoo.com,2167291825,,Matthew Walker,46615 Nancy Mount Suite 973,,,,,,,,,United States,US,NM,Albuquerque,Publish notice sent to your fans,
508,1/19/20 10:34pm,Bandcamp,album,Afelan,Mdou Moctar,USD,7.0,1.0,,7.0,,,,0.61,credit card,7.0,0.0,873098700,,0.7,0.0,0.7,0.0,160.11,5.69,digital download,,http://mdoumoctar.bandcamp.com/album/afelan,,SS-017,889326 664840,,Kenneth Harris,jacksonmichael@hotmail.com,503-286-9170,,Rachel Mills,75627 Petty Squares,,,,,,,,,United States,US,CA,Costa Mesa,en.wikipedia.org,en.wikipedia.org/
509,1/19/20 10:34pm,Bandcamp,album,Akounak Tedalat Taha Tazoughai OST,Mdou Moctar,USD,7.0,1.0,,7.0,,,,,,7.0,0.0,873098700,,0.7,1.4,0.0,11.99,172.1,6.3,digital download,,http://mdoumoctar.bandcamp.com/album/akounak-tedalat-taha-tazoughai-ost,,SS-028,889326 667599,,Kenneth Harris,elizabeth45@yahoo.com,(722)735-0255x60759,,David Horne,697 Williams Crest,,,,,,,,,United States,US,CA,Costa Mesa,,
510,1/19/20 10:57pm,Bandcamp,album,Music from Saharan WhatsApp,Etran de L'Aïr,USD,5.0,1.0,,5.0,,,,0.3,credit card,5.0,0.0,1034608090,,0.5,0.5,0.0,4.2,176.3,4.2,digital download,,http://etrandelair.bandcamp.com/album/music-from-saharan-whatsapp,,WHATSAPP-01,,,Kenneth Harris,nancyvaldez@gmail.com,314.258.3485x6729,,Zachary Pena,2204 Garcia Haven,,,,,,,,,United States,US,CA,Costa Mesa,,
511,1/19/20 11:16pm,Bandcamp,album,Music from Saharan WhatsApp,Etran de L'Aïr,USD,3.0,1.0,,3.0,,,,0.2,paypal,3.0,0.0,1864059650,,0.3,0.3,0.0,2.5,178.8,2.5,digital download,,http://etrandelair.bandcamp.com/album/music-from-saharan-whatsapp,,WHATSAPP-01,,,Julia Harrison,blanchardthomas@gmail.com,8376166545,,Stephen Welch,60720 Arnold Ramp,,,,,,,,,United States,US,IL,Skokie,Google search,www.google.com/
512,1/20/20 12:28am,Bandcamp,album,Music from Saharan WhatsApp,Etran de L'Aïr,USD,6.0,1.0,,6.0,,,,0.35,paypal,6.0,0.0,4088475922,,0.6,0.6,0.0,5.05,183.85,5.05,digital download,,http://etrandelair.bandcamp.com/album/music-from-saharan-whatsapp,,WHATSAPP-01,,,Carrie Lowe,xcarlson@archer.biz,001-982-546-8757x82765,,Marilyn Lee,70032 Raymond Parkway Suite 394,,,,,,,,,United States,US,WA,Tacoma,Facebook,m.facebook.com
513,1/20/20 12:34am,Bandcamp,album,Music from Saharan WhatsApp,Etran de L'Aïr,USD,1.5,1.0,,1.5,,,,0.13,paypal,1.5,0.0,2295036510,,0.15,0.15,0.0,1.22,185.07,1.22,digital download,,http://etrandelair.bandcamp.com/album/music-from-saharan-whatsapp,,WHATSAPP-01,,,Mariah Richardson,lauriehall@yahoo.com,+1-413-006-9947x729,,Donald Sawyer,790 Herrera Cliff,,,,,,,,,United Kingdom,GB,Lambeth,Balham,Google search,www.google.com/
514,1/20/20 1:28am,Bandcamp,package,Ilana: The Creator,Mdou Moctar,USD,45.0,1.0,,45.0,,6.0,United States,1.27,paypal,51.0,0.0,1661223120,,4.5,4.5,0.0,45.23,230.3,39.23,Ilana The Creator shirt & LP bundle,LARGE,http://mdoumoctar.bandcamp.com/merch/ilana-the-creator-shirt-lp-bundle,SS-051lp*-T02-W-ULG,,,,David Bauer,dianafitzgerald@gmail.com,+1-166-383-6662,,Kenneth Rodriguez,50653 Caldwell Hill,,Coral Springs,FL,33071,United States,US,1/21/20,,United States,US,FL,Coral Springs,Bandcamp home page,bandcamp.com/
515,1/20/20 1:41am,Bandcamp,album,Music from Saharan WhatsApp,Etran de L'Aïr,USD,1.0,1.0,,1.0,,,,0.1,credit card,1.0,0.0,1269386185,,0.1,0.1,0.0,0.8,231.1,0.8,digital download,,http://etrandelair.bandcamp.com/album/music-from-saharan-whatsapp,,WHATSAPP-01,,,Michelle Perez,martinezjennifer@garner.org,+1-278-424-9360,,Brian Watson,6159 Carol Mountain Suite 777,,,,,,,,,United States,US,MO,Kansas City,Bandcamp search,bandcamp.com/autocomplete-search
516,1/20/20 2:45am,Bandcamp,package,Ilana: The Creator,Mdou Moctar,USD,17.0,1.0,,17.0,,5.0,United States,0.72,paypal,22.0,0.0,691112382,,1.7,1.7,0.0,19.58,250.68,14.58,Ilana LP,,http://mdoumoctar.bandcamp.com/album/ilana-the-creator,SS-051lp,SS-051,602318 136893,,Alejandro Bailey,swilson@gmail.com,162-897-2349x095,,Rebecca Gilbert,8815 Rachel Fall,Apartment A,Springfield,OR,97477,United States,US,1/21/20,,United States,US,OR,Springfield,duckduckgo.com,duckduckgo.com/
517,1/20/20 4:09am,Bandcamp,album,Music from Saharan Cellphones,Various,USD,7.0,1.0,,7.0,,,,0.4,paypal,7.0,0.0,1001687374,,0.7,0.7,0.0,5.9,256.58,5.9,digital download,,http://sahelsounds.bandcamp.com/album/music-from-saharan-cellphones,,SS-003,889326 667889,,Darlene James,snelson@gmail.com,+1-598-970-1894x16859,,Chris Cisneros,692 Michael Plaza,,,,,,,,,United States,US,KY,Brandenburg,,
518,1/20/20 5:14am,Bandcamp,album,Music from Saharan WhatsApp,Etran de L'Aïr,USD,2.0,1.0,,2.0,,,,0.15,credit card,2.0,0.0,1527141814,,0.2,0.2,0.0,1.65,258.23,1.65,digital download,,http://etrandelair.bandcamp.com/album/music-from-saharan-whatsapp,,WHATSAPP-01,,,Tina Evans,davidbryant@foster-olson.com,+1-384-930-2790x1763,,Jessica Powell,0769 Daniels Shore Suite 964,,,,,,,,,United States,US,CA,San Francisco,Bandcamp New & Notable,bandcamp.com/#new-notable
519,1/20/20 5:44am,Bandcamp,album,Music from Saharan Cellphones,Various,USD,7.0,1.0,,7.0,,,,0.4,paypal,7.0,0.0,201765391,,0.7,0.7,0.0,5.9,264.13,5.9,digital download,,http://sahelsounds.bandcamp.com/album/music-from-saharan-cellphones,,SS-003,889326 667889,,Gloria Hess,nfinley@bond-white.com,+1-712-410-6682,,Mary Elliott,9600 Amy Views Suite 998,,,,,,,,,United States,US,CA,Santa Clara,,
520,1/20/20 8:42am,Bandcamp,album,Music from Saharan WhatsApp,Etran de L'Aïr,USD,3.0,1.0,,3.0,,,,0.23,paypal,3.0,0.0,2002405652,,0.3,0.3,0.0,2.47,266.6,2.47,digital download,,http://etrandelair.bandcamp.com/album/music-from-saharan-whatsapp,,WHATSAPP-01,,,Lisa Wu,alexandermcbride@young.com,(503)878-0016,,Christine Davis,51115 Allison Pine,,,,,,,,,United Kingdom,GB,Bristol,Bristol,,
521,1/20/20 4:24pm,Bandcamp,album,Music from Saharan WhatsApp,Etran de L'Aïr,USD,1.0,1.0,,1.0,,,,0.11,paypal,1.0,0.0,2708024795,,0.1,0.1,0.0,0.79,267.39,0.79,digital download,,http://etrandelair.bandcamp.com/album/music-from-saharan-whatsapp,,WHATSAPP-01,,,David Frazier,samuel89@hotmail.com,2300576389,,Jennifer Hayden,445 Walters Divide,,,,,,,,,Ireland,IE,Leinster,Dublin,Bandcamp fan wishlist,bandcamp.com/adrianconstable
522,1/20/20 4:25pm,Bandcamp,album,Les Filles de Illighadad,Les Filles de Illighadad,USD,7.0,1.0,,7.0,1.61,,,0.58,credit card,8.61,0.0,4007502752,,0.7,0.7,0.0,5.72,273.11,5.72,digital download,,http://lesfillesdeillighadad.bandcamp.com/album/les-filles-de-illighadad,,SS-033,889326 664918,,Melissa Mccoy,fsanford@gmail.com,588.204.7419,,Erik Lopez,97134 Phillips Points,,,,,,,,,Ireland,IE,County Carlow,Carlow,Google search,www.google.com/
523,1/20/20 5:41pm,Bandcamp,album,Music from Saharan WhatsApp,Etran de L'Aïr,USD,1.3,1.0,,1.3,,,,0.13,paypal,1.3,0.0,49135189,,0.13,0.13,0.0,1.04,274.15,1.04,digital download,,http://etrandelair.bandcamp.com/album/music-from-saharan-whatsapp,,WHATSAPP-01,,,John Thornton,susanmiller@ortega.com,865-708-2404,,Danielle Moyer,41074 Novak Tunnel Apt. 059,,,,,,,,,United Kingdom,GB,Sheffield,Sheffield,Bandcamp fan page: ethann__smith,bandcamp.com/ethann__smith/wishlist
524,1/20/20 5:53pm,Bandcamp,album,Music from Saharan WhatsApp,Etran de L'Aïr,USD,3.0,1.0,,3.0,,,,0.2,paypal,3.0,0.0,359676804,,0.3,0.3,0.0,2.5,276.65,2.5,digital download,,http://etrandelair.bandcamp.com/album/music-from-saharan-whatsapp,,WHATSAPP-01,,,Richard Vega,murphychristy@hotmail.com,+1-224-426-7353x26597,,Kelsey Byrd,12049 Allen Skyway Suite 530,,,,,,,,,United States,US,CO,Colorado Springs,Bandcamp search,bandcamp.com/autocomplete-search
525,1/20/20 6:02pm,shop@sahelsounds.com,payout,,,USD,,,,,,,,1.33,transfer,133.05,131.72,t252664279,6XF273511P5500939,,,,-133.05,143.6,,,,,,,,,,,,,,,,,,,,,,,,,,,,
526,1/20/20 6:02pm,shop@sahelsounds.com,payout,,,USD,,,,,,,,0.16,transfer,16.38,16.22,t252664278,3DW217516W5933245,,,,-16.38,127.22,,,,,,,,,,,,,,,,,,,,,,,,,,,,
527,1/20/20 7:17pm,Bandcamp,album,Music from Saharan WhatsApp,Etran de L'Aïr,USD,1.0,1.0,,1.0,,,,0.11,paypal,1.0,0.0,59531789,,0.1,0.1,0.0,0.79,128.01,0.79,digital download,,http://etrandelair.bandcamp.com/album/music-from-saharan-whatsapp,,WHATSAPP-01,,,Lisa Gentry,yneal@morgan-jackson.com,5964118009,,Robert Nguyen,3134 Gonzalez Parkway Suite 653,,,,,,,,,Belgium,BE,West Flanders Province,Kortrijk,Publish notice sent to your fans,
528,1/20/20 7:21pm,Bandcamp,album,Music from Saharan WhatsApp,Etran de L'Aïr,USD,3.0,1.0,,3.0,,,,0.2,gift card,3.0,0.0,3942437132,,0.3,0.3,0.0,2.5,130.51,2.5,digital download,,http://etrandelair.bandcamp.com/album/music-from-saharan-whatsapp,,WHATSAPP-01,,,Kenneth Mahoney,gnguyen@hotmail.com,(399)026-4227,,Rebecca Boyd,745 Barbara Throughway Suite 214,,,,,,,,,United States,US,NY,Sunnyside,Bandcamp: thomasmartin19/following/artists_and_labels,bandcamp.com/thomasmartin19/following/artists_and_labels
529,1/20/20 8:14pm,Bandcamp,album,Music from Saharan WhatsApp,Etran de L'Aïr,USD,1.0,1.0,,1.0,,,,0.1,credit card,1.0,0.0,3186883997,,0.1,0.1,0.0,0.8,131.31,0.8,digital download,,http://etrandelair.bandcamp.com/album/music-from-saharan-whatsapp,,WHATSAPP-01,,,Ivan Sherman,matthewfaulkner@gmail.com,(911)396-3748,,Lori Hughes,53943 Lori Well,,,,,,,,,United States,US,CA,Los Angeles,Bandcamp Discover,bandcamp.com/#discover
530,1/20/20 8:24pm,Bandcamp,album,Music from Saharan WhatsApp,Etran de L'Aïr,USD,2.0,1.0,,2.0,,,,0.17,paypal,2.0,0.0,363484471,,0.2,0.2,0.0,1.63,132.94,1.63,digital download,,http://etrandelair.bandcamp.com/album/music-from-saharan-whatsapp,,WHATSAPP-01,,,Joyce Orozco,robert50@gmail.com,001-002-576-4960,,Heather Anderson,269 Silva Junctions Apt. 450,,,,,,,,,United Kingdom,GB,,,Bandcamp music feed,http://blog.bandcamp.com/2014/01/30/bandcamp-app-now-with-music-feed/
531,1/20/20 9:06pm,Bandcamp,album,Music from Saharan WhatsApp,Etran de L'Aïr,USD,3.0,1.0,,3.0,,,,0.2,credit card,3.0,0.0,2871909099,,0.3,0.3,0.0,2.5,135.44,2.5,digital download,,http://etrandelair.bandcamp.com/album/music-from-saharan-whatsapp,,WHATSAPP-01,,,Kelsey Ellison,morrisonmichael@gmail.com,001-957-127-5664x2086,,Adrian Perry,40945 Amy Passage,,,,,,,,,United States,US,CA,San Jose,Publish notice sent to your fans,
532,1/20/20 9:21pm,Bandcamp,album,Music from Saharan WhatsApp,Etran de L'Aïr,USD,5.0,1.0,,5.0,,,,0.3,credit card,5.0,0.0,714252370,,0.5,0.5,0.0,4.2,139.64,4.2,digital download,,http://etrandelair.bandcamp.com/album/music-from-saharan-whatsapp,,WHATSAPP-01,,,Yolanda Todd,ortegaapril@yahoo.com,951-501-2779x387,,Juan Mora,920 Ortega Plain,,,,,,,,,United States,US,CA,Hayward,,
533,1/20/20 10:11pm,Bandcamp,package,Ilana: The Creator,Mdou Moctar,USD,17.0,1.0,,17.0,,5.0,United States,0.78,credit card,22.0,0.0,3243437546,,1.7,1.7,0.0,19.52,159.16,14.52,Ilana LP,,http://mdoumoctar.bandcamp.com/album/ilana-the-creator,SS-051lp,SS-051,602318 136893,,Linda Phillips,pstewart@romero.org,913-430-9166,,Renee Dawson,25628 Justin Drive Apt. 272,,Fish Creek,WI,54212,United States,US,1/21/20,,United States,US,WI,Fish Creek,Bandcamp search: “mdou moctar”,bandcamp.com/search?q=mdou%20moctar
534,1/20/20 10:19pm,Bandcamp,album,Music from Saharan WhatsApp,Etran de L'Aïr,USD,1.0,1.0,,1.0,,,,0.1,credit card,1.0,0.0,4178026366,,0.1,0.1,0.0,0.8,159.96,0.8,digital download,,http://etrandelair.bandcamp.com/album/music-from-saharan-whatsapp,,WHATSAPP-01,,,Denise Ortega,kathy50@hotmail.com,731-601-0240x377,,Larry Ortiz,693 Michelle Coves,,,,,,,,,United States,US,CA,Los Angeles,,
535,1/20/20 11:20pm,Bandcamp,album,Music from Saharan WhatsApp,Etran de L'Aïr,USD,2.0,1.0,,2.0,,,,0.15,paypal,2.0,0.0,3885436636,,0.2,0.2,0.0,1.65,161.61,1.65,digital download,,http://etrandelair.bandcamp.com/album/music-from-saharan-whatsapp,,WHATSAPP-01,,,Holly Lawson,cameron95@yahoo.com,+1-977-984-8207x21442,,Kristina Thomas,544 Wiggins Plaza,,,,,,,,,United States,US,MO,St Louis,,
536,1/21/20 12:48am,Bandcamp,album,Music from Saharan WhatsApp,Etran de L'Aïr,USD,5.0,1.0,,5.0,,,,0.3,paypal,5.0,0.0,2591916513,,0.5,0.5,0.0,4.2,165.81,4.2,digital download,,http://etrandelair.bandcamp.com/album/music-from-saharan-whatsapp,,WHATSAPP-01,,,Michael Sanchez,katherineparker@cole.com,+1-984-819-9607x5207,,Christopher Rojas,051 Morgan Mill,,,,,,,,,United States,US,CA,San Francisco,Bandcamp weekly newsletter,bandcamp.com
537,1/21/20 2:17am,Bandcamp,package,Eghass Malan,Les Filles de Illighadad,USD,17.0,1.0,,17.0,,5.0,United States,1.08,paypal,22.0,0.0,3127716276,,1.7,0.0,1.7,0.0,165.81,14.22,'Eghass Malan' LP,,http://lesfillesdeillighadad.bandcamp.com/album/eghass-malan,SS-044lp-1,SS-044,191515 928351,,Debra Caldwell,kenneth17@barton-hoffman.com,+1-396-365-4670,,Autumn Price,8002 Adams Islands,,chicago,IL,60622,United States,US,1/21/20,,United States,US,IL,chicago,youtube.com,www.youtube.com/
538,1/21/20 2:17am,Bandcamp,package,Les Filles de Illighadad,Les Filles de Illighadad,USD,17.0,1.0,,17.0,,2.0,United States,,,19.0,0.0,3127716276,,1.7,3.4,0.0,36.52,202.33,15.3,Les Filles de Illighadad LP,,http://lesfillesdeillighadad.bandcamp.com/album/les-filles-de-illighadad,SS-033-LP,SS-033,889326 664918,,Debra Caldwell,michelle72@hotmail.com,439-417-4537,,Corey Patton,0564 Nolan Shore,,chicago,IL,60622,United States,US,1/21/20,,United States,US,IL,chicago,youtube.com,www.youtube.com/
539,1/21/20 5:44am,Bandcamp,album,Music from Saharan WhatsApp,Etran de L'Aïr,USD,1.0,1.0,,1.0,,,,0.1,paypal,1.0,0.0,1423725623,,0.1,0.1,0.0,0.8,203.13,0.8,digital download,,http://etrandelair.bandcamp.com/album/music-from-saharan-whatsapp,,WHATSAPP-01,,,Christina Gilbert,danielwilliams@hotmail.com,(017)863-9253x90956,,Daniel Smith,862 Clark Skyway,,,,,,,,,United States,US,MD,Towson,Bandcamp music feed,http://blog.bandcamp.com/2014/01/30/bandcamp-app-now-with-music-feed/
540,1/21/20 7:32am,Bandcamp,album,Music from Saharan WhatsApp,Etran de L'Aïr,USD,5.0,1.0,,5.0,,,,0.35,credit card,5.0,0.0,4193897684,,0.5,0.5,0.0,4.15,207.28,4.15,digital download,,http://etrandelair.bandcamp.com/album/music-from-saharan-whatsapp,,WHATSAPP-01,,,Ashley Campbell,whill@hotmail.com,(755)904-9837x2296,,Brandon Wells,671 Marshall Motorway,,,,,,,,,Canada,CA,BC,Vancouver,,
541,1/21/20 8:48am,Bandcamp,album,Music from Saharan WhatsApp,Etran de L'Aïr,USD,1.0,1.0,,1.0,,,,0.11,credit card,1.0,0.0,1442005975,,0.1,0.1,0.0,0.79,208.07,0.79,digital download,,http://etrandelair.bandcamp.com/album/music-from-saharan-whatsapp,,WHATSAPP-01,,,Faith Carter,reynoldscaitlin@stewart-crawford.com,876-739-2125x45977,,Brandon Jones,909 Green Village Apt. 675,,,,,,,,,United Kingdom,GB,England,London,,
542,1/21/20 12:19pm,Bandcamp,album,Waande Kadde,Amadou Binta Konté and Tidiane Thiam,USD,10.0,1.0,,10.0,,,,0.49,paypal,10.0,0.0,3271301894,,1.0,1.0,0.0,8.51,216.58,8.51,digital download,,http://sahelsounds.bandcamp.com/album/waande-kadde,,SS-036 / SFH-01,889326 796008,,Matthew Carroll,brian51@hotmail.com,831-780-6330,,Melissa Simon,233 Jonathan Point Suite 200,,,,,,,,,United States,US,PA,Philadelphia,,
543,1/21/20 2:23pm,Bandcamp,album,Music from Saharan Cellphones,Various,USD,10.0,1.0,,10.0,,,,0.49,paypal,10.0,0.0,3506430162,,1.0,1.0,0.0,8.51,225.09,8.51,digital download,,http://sahelsounds.bandcamp.com/album/music-from-saharan-cellphones,,SS-003,889326 667889,,Michael Fields,renee24@miller.com,0566010694,,Alice Anderson,59220 Blake Underpass,,,,,,,,,United States,US,NH,Lebanon,messages.google.com,messages.google.com/web/conversations/35?redirected=true
544,1/21/20 5:36pm,Bandcamp,track,Anou Malane,Abdallah Ag Oumbadougou,USD,1.0,1.0,,1.0,0.2,,,0.12,paypal,1.2,0.0,3091553507,,0.1,0.1,0.0,0.78,225.87,0.78,digital download,,http://abdallahagoumbadougou.bandcamp.com/track/anou-malane,,SS-053,,,Nicole Jackson,andersontanya@hotmail.com,(257)678-9151x7339,,Richard Brandt,724 Chase Port Suite 648,,,,,,,,,United Kingdom,GB,West Sussex,Henfield,Bandcamp fan page: techsupportrecordings,bandcamp.com/techsupportrecordings/wishlist
545,1/21/20 6:02pm,shop@sahelsounds.com,payout,,,USD,,,,,,,,0.39,transfer,38.97,38.58,t252885641,4K179807AG588520J,,,,-38.97,186.9,,,,,,,,,,,,,,,,,,,,,,,,,,,,
546,1/21/20 6:03pm,shop@sahelsounds.com,payout,,,USD,,,,,,,,0.88,transfer,88.25,87.37,t252885640,5X310201216667849,,,,-88.25,98.65,,,,,,,,,,,,,,,,,,,,,,,,,,,,
547,1/21/20 6:22pm,Bandcamp,album,Music from Saharan WhatsApp,Etran de L'Aïr,USD,3.56,1.0,,3.56,,,,0.26,paypal,3.56,0.0,1085116256,,0.36,0.36,0.0,2.94,101.59,2.94,digital download,,http://etrandelair.bandcamp.com/album/music-from-saharan-whatsapp,,WHATSAPP-01,,,Christopher Martinez,kenneth59@gmail.com,(665)641-3522x270,,Dennis Torres,99702 Pierce Spur,,,,,,,,,Brazil,BR,Federal District,Brasília,Bandcamp music feed,http://blog.bandcamp.com/2014/01/30/bandcamp-app-now-with-music-feed/
548,1/21/20 7:47pm,Bandcamp,album,Music from Saharan WhatsApp,Etran de L'Aïr,USD,4.0,1.0,,4.0,,,,0.29,credit card,4.0,0.0,1155617562,,0.4,0.4,0.0,3.31,104.9,3.31,digital download,,http://etrandelair.bandcamp.com/album/music-from-saharan-whatsapp,,WHATSAPP-01,,,Sarah Wong,lauren18@ballard.com,954.136.8111,,Rhonda Martin,8961 Michael Station Apt. 328,,,,,,,,,United Kingdom,GB,Birmingham,Birmingham,Bandcamp fan page: ptb,bandcamp.com/ptb
549,1/21/20 7:51pm,Bandcamp,album,Music from Saharan WhatsApp,Etran de L'Aïr,USD,3.0,1.0,,3.0,,,,0.23,paypal,3.0,0.0,2510452329,,0.3,0.3,0.0,2.47,107.37,2.47,digital download,,http://etrandelair.bandcamp.com/album/music-from-saharan-whatsapp,,WHATSAPP-01,,,Jade Moss,davidclark@hotmail.com,286.051.6826x364,,Julie Harper,54403 Scott Valleys,,,,,,,,,France,FR,Maine-et-Loire,Le Lion-dAngers,,
550,1/21/20 8:39pm,Bandcamp,album,Music from Saharan WhatsApp,Etran de L'Aïr,USD,5.0,1.0,,5.0,,,,0.3,paypal,5.0,0.0,2774561367,,0.5,0.5,0.0,4.2,111.57,4.2,digital download,,http://etrandelair.bandcamp.com/album/music-from-saharan-whatsapp,,WHATSAPP-01,,,Cody Thomas,wangmatthew@yahoo.com,(577)268-5728,,Stephen Bruce,949 Leah Ways Apt. 192,,,,,,,,,United States,US,NY,Brooklyn,,
551,1/21/20 9:14pm,Bandcamp,album,Music from Saharan WhatsApp,Etran de L'Aïr,USD,10.0,1.0,,10.0,,,,0.59,paypal,10.0,0.0,2516435125,,1.0,1.0,0.0,8.41,119.98,8.41,digital download,,http://etrandelair.bandcamp.com/album/music-from-saharan-whatsapp,,WHATSAPP-01,,,Kimberly Anderson,zvalencia@yahoo.com,001-899-375-1454,,Thomas Nielsen,894 Joe Lock,,,,,,,,,Canada,CA,QC,Montreal,Bandcamp search,bandcamp.com/app/android/search
552,1/21/20 9:53pm,Bandcamp,album,Music from Saharan WhatsApp,Etran de L'Aïr,USD,1.0,1.0,,1.0,,,,0.1,paypal,1.0,0.0,1325701351,,0.1,0.1,0.0,0.8,120.78,0.8,digital download,,http://etrandelair.bandcamp.com/album/music-from-saharan-whatsapp,,WHATSAPP-01,,,Barbara Marquez,sharon07@burns.com,001-291-219-1112,,Tanya Wilson,5420 Dennis Place Apt. 866,,,,,,,,,United States,US,PA,Quakertown,Bandcamp fan page: arctostaphylos,bandcamp.com/arctostaphylos
553,1/21/20 10:36pm,Bandcamp,album,Music from Saharan WhatsApp,Etran de L'Aïr,USD,1.0,1.0,,1.0,,,,0.1,paypal,1.0,0.0,2155972125,,0.1,0.1,0.0,0.8,121.58,0.8,digital download,,http://etrandelair.bandcamp.com/album/music-from-saharan-whatsapp,,WHATSAPP-01,,,Marissa Brown,wwalters@hughes.info,381.371.8451x06740,,Andrew Erickson,95141 Harrison Spurs Suite 145,,,,,,,,,United States,US,TX,Austin,Bandcamp fan wishlist,bandcamp.com/shando
554,1/21/20 11:15pm,Bandcamp,package,Akounak Tedalat Taha Tazoughai OST,Mdou Moctar,USD,17.0,1.0,,17.0,,5.0,United States,0.78,credit card,22.0,0.0,3215420242,,1.7,1.7,0.0,19.52,141.1,14.52,Akounak OST LP,,http://mdoumoctar.bandcamp.com/album/akounak-tedalat-taha-tazoughai-ost,SS-028lp-1,SS-028,889326 667599,,Stephen Rodriguez,lreed@yahoo.com,140-640-2012x58628,,Russell Ramirez,7097 Fitzgerald Tunnel,,Woburn,MA,1801,United States,US,1/28/20,,United States,US,MA,Woburn,Google search,www.google.com/
555,1/22/20 12:47am,Bandcamp,album,Music from Saharan WhatsApp,Etran de L'Aïr,USD,4.0,1.0,,4.0,,,,0.29,credit card,4.0,0.0,2284670820,,0.4,0.4,0.0,3.31,144.41,3.31,digital download,,http://etrandelair.bandcamp.com/album/music-from-saharan-whatsapp,,WHATSAPP-01,,,Pamela Moore,patrick76@sutton.com,001-665-912-5435,,Mathew Gomez,3821 Michael Courts Suite 882,,,,,,,,,Norway,NO,,Oppegard,Bandcamp search,bandcamp.com/autocomplete-search
556,1/22/20 1:22am,Bandcamp,album,Music from Saharan WhatsApp,Etran de L'Aïr,USD,1.0,1.0,,1.0,,,,0.1,paypal,1.0,0.0,2192876647,,0.1,0.1,0.0,0.8,145.21,0.8,digital download,,http://etrandelair.bandcamp.com/album/music-from-saharan-whatsapp,,WHATSAPP-01,,,Dylan Moore,nelsongabrielle@hotmail.com,+1-067-588-8670x880,,William Hood,9756 Kimberly Canyon,,,,,,,,,United States,US,AZ,Goodyear,,
557,1/22/20 2:19am,Bandcamp,album,Music from Saharan WhatsApp,Etran de L'Aïr,USD,3.0,1.0,,3.0,,,,0.11,credit card,3.0,0.0,3086407130,,0.3,0.3,0.0,2.59,147.8,2.59,digital download,,http://etrandelair.bandcamp.com/album/music-from-saharan-whatsapp,,WHATSAPP-01,,,Thomas Rivera,vrosales@ferguson.com,001-709-335-1115x419,,Nicholas Novak,35399 Nelson Station,,,,,,,,,United States,US,VA,Arlington,Bandcamp: akarsh/following/artists_and_labels,bandcamp.com/akarsh/following/artists_and_labels
558,1/22/20 3:13am,Bandcamp,album,Music from Saharan WhatsApp,Etran de L'Aïr,USD,3.0,1.0,,3.0,,,,0.2,paypal,3.0,0.0,2586069611,,0.3,0.3,0.0,2.5,150.3,2.5,digital download,,http://etrandelair.bandcamp.com/album/music-from-saharan-whatsapp,,WHATSAPP-01,,,Jonathan Flynn,jonathanthomas@gmail.com,(654)386-8175,,Kim Aguilar,914 Lambert Trail,,,,,,,,,United States,US,IL,Champaign,Google search,www.google.com/
559,1/22/20 3:44am,Bandcamp,package,Falaw,Luka Productions,USD,17.0,1.0,,17.0,,5.0,United States,0.77,credit card,22.0,0.0,4043528733,,1.7,1.7,0.0,19.53,169.83,14.53,Limited Edition Vinyl,,http://lukaproductions.bandcamp.com/album/falaw,SS-052lp,SS-052,602318 136855,,Thomas Rivera,rossrobert@gmail.com,+1-916-008-8224x77203,,Lisa Hayes,2145 Christopher Rapid Suite 095,,Arlington,VA,22205,United States,US,1/28/20,,United States,US,VA,Arlington,,
560,1/22/20 4:36am,Bandcamp,album,Music from Saharan Cellphones: Volume 2,Various,USD,7.0,1.0,,7.0,,,,0.4,paypal,7.0,0.0,2594350010,,0.7,0.7,0.0,5.9,175.73,5.9,digital download,,http://sahelsounds.bandcamp.com/album/music-from-saharan-cellphones-volume-2,,SS-012,889326 667742,,Andrew White,jeremyanderson@hotmail.com,(369)580-4646x9980,,Christy White,18439 Gilbert Loaf Suite 274,,,,,,,,,United States,US,SC,Beaufort,Google search,www.google.com/
561,1/22/20 4:38am,Bandcamp,package,Hali Diallo,Tallawit Timbouctou,USD,17.0,1.0,,17.0,,2.0,United States,2.1,credit card,19.0,0.0,2507950137,,1.7,0.0,1.7,0.0,175.73,13.2,Vinyl LP,,http://tallawit.bandcamp.com/album/hali-diallo,SS-048lp,SS-048,656605 382265,,Destiny Romero,rodgersjon@pena.com,(967)187-4256,,Robert Williams,0809 Vang Ranch Suite 104,,Boise,ID,83705,United States,US,1/28/20,,United States,US,ID,Boise,,
562,1/22/20 4:38am,Bandcamp,package,Akounak Tedalat Taha Tazoughai OST,Mdou Moctar,USD,17.0,1.0,,17.0,,2.0,United States,,,19.0,0.0,2507950137,,1.7,0.0,3.4,0.0,175.73,15.3,Akounak OST LP,,http://mdoumoctar.bandcamp.com/album/akounak-tedalat-taha-tazoughai-ost,SS-028lp-1,SS-028,889326 667599,,Destiny Romero,amy94@stone-andrews.com,367-954-0663,,Alexandra Wallace,585 Leslie Plains,,Boise,ID,83705,United States,US,1/28/20,,United States,US,ID,Boise,,
563,1/22/20 4:38am,Bandcamp,package,Afelan,Mdou Moctar,USD,17.0,1.0,,17.0,,2.0,United States,,,19.0,0.0,2507950137,,1.7,0.0,5.1,0.0,175.73,15.3,Afelan LP,,http://mdoumoctar.bandcamp.com/album/afelan,SS-017lp,SS-017,889326 664840,,Destiny Romero,tylerhiggins@hotmail.com,001-616-234-1603x947,,Peter Fuller,1640 Tara Stream Apt. 841,,Boise,ID,83705,United States,US,1/28/20,,United States,US,ID,Boise,,
564,1/22/20 4:38am,Bandcamp,package,Sahel Sounds Label Sampler,Various Artists,USD,20.0,1.0,,20.0,,5.0,United States,,,25.0,0.0,2507950137,,2.0,7.1,0.0,72.8,248.53,18.0,Sahel Sounds t-shirt,XL,http://sahelsounds.bandcamp.com/merch/sahel-sounds-t-shirt,SS-T01-BLK-UXL,,,,Destiny Romero,mary52@matthews-burnett.com,001-489-024-1187x1416,,Timothy Love,9426 Erickson Rue Suite 307,,Boise,ID,83705,United States,US,1/28/20,,United States,US,ID,Boise,Google search,www.google.com/
565,1/22/20 8:50am,Bandcamp,album,Music from Saharan WhatsApp,Etran de L'Aïr,USD,2.0,1.0,,2.0,,,,0.17,paypal,2.0,0.0,1023229598,,0.2,0.2,0.0,1.63,250.16,1.63,digital download,,http://etrandelair.bandcamp.com/album/music-from-saharan-whatsapp,,WHATSAPP-01,,,Terri Park,andersonpeter@yahoo.com,(079)241-7069x66637,,Edward Strong,341 Parrish Dam Suite 717,,,,,,,,,Poland,PL,Mazovia,Warsaw,Bandcamp search,bandcamp.com/autocomplete-search
566,1/22/20 10:44am,Bandcamp,album,Music from Saharan WhatsApp,Etran de L'Aïr,USD,1.0,1.0,,1.0,,,,0.11,credit card,1.0,0.0,218818822,,0.1,0.1,0.0,0.79,250.95,0.79,digital download,,http://etrandelair.bandcamp.com/album/music-from-saharan-whatsapp,,WHATSAPP-01,,,Carol Anderson,kevin69@alvarado-miller.com,968-844-0485x0368,,Christopher Garcia,4377 Walker Center,,,,,,,,,United Kingdom,GB,England,London,,
567,1/22/20 11:22am,Bandcamp,album,Ilana: The Creator,Mdou Moctar,USD,7.0,1.0,,7.0,,,,0.47,paypal,7.0,0.0,1423522268,,0.7,0.7,0.0,5.83,256.78,5.83,digital download,,http://mdoumoctar.bandcamp.com/album/ilana-the-creator,,SS-051,602318 136893,,Julie Page,maciasdylan@alexander-russell.net,+1-610-036-6342x488,,Pamela Fletcher,824 Kennedy Heights Suite 962,,,,,,,,,Australia,AU,QLD,Toowoomba,Bandcamp artist: mdoumoctar,mdoumoctar.bandcamp.com
568,1/22/20 11:38am,Bandcamp,package,Hali Diallo,Tallawit Timbouctou,USD,17.0,1.0,,17.0,,4.0,United States,2.83,paypal,21.0,0.0,3177458495,,1.7,0.0,1.7,0.0,256.78,12.47,Vinyl LP,,http://tallawit.bandcamp.com/album/hali-diallo,SS-048lp,SS-048,656605 382265,,Calvin Hopkins,spencerrebekah@gmail.com,(144)044-4606,,Eddie Daniels,017 Jon Expressway,7-17 LATONA ROAD,LONDON,,SE15 6RY,United Kingdom,GB,1/28/20,,United Kingdom,GB,,LONDON,,
569,1/22/20 11:38am,Bandcamp,package,Ilana: The Creator,Mdou Moctar,USD,17.0,1.0,,17.0,,4.0,United States,,,21.0,0.0,3177458495,,1.7,0.0,3.4,0.0,256.78,15.3,Ilana LP,,http://mdoumoctar.bandcamp.com/album/ilana-the-creator,SS-051lp,SS-051,602318 136893,,Calvin Hopkins,johnking@hotmail.com,001-668-455-1626x98890,,Timothy Powell,789 Williams Extensions Apt. 907,7-17 LATONA ROAD,LONDON,,SE15 6RY,United Kingdom,GB,1/28/20,,United Kingdom,GB,,LONDON,,
570,1/22/20 11:38am,Bandcamp,package,Anou Malane,Abdallah Ag Oumbadougou,USD,17.0,1.0,,17.0,,4.0,United States,,,21.0,0.0,3177458495,,1.7,0.0,5.1,0.0,256.78,15.3,Vinyl,,http://abdallahagoumbadougou.bandcamp.com/album/anou-malane,SS-053lp,SS-053,602318 136992,,Calvin Hopkins,nsilva@gmail.com,7125817793,,Matthew Lopez,580 Bradley Grove Suite 029,7-17 LATONA ROAD,LONDON,,SE15 6RY,United Kingdom,GB,1/28/20,,United Kingdom,GB,,LONDON,,
571,1/22/20 11:38am,Bandcamp,package,Houmeissa,Hama,USD,17.0,1.0,,17.0,,4.0,United States,,,21.0,0.0,3177458495,,1.7,0.0,6.8,0.0,256.78,15.3,Hama - Houmeissa LP,,http://hamasynth.bandcamp.com/album/houmeissa,SS-049lp,SS-049,656605 382364,,Calvin Hopkins,caitlin94@myers.net,583.117.2697x6941,,David Mayo,0359 Benjamin Hollow,7-17 LATONA ROAD,LONDON,,SE15 6RY,United Kingdom,GB,1/28/20,,United Kingdom,GB,,LONDON,,
572,1/22/20 11:38am,Bandcamp,package,Falaw,Luka Productions,USD,17.0,1.0,,17.0,,24.0,United States,,,41.0,0.0,3177458495,,1.7,0.0,8.5,0.0,256.78,15.3,Limited Edition Vinyl,,http://lukaproductions.bandcamp.com/album/falaw,SS-052lp,SS-052,602318 136855,,Calvin Hopkins,dustin07@hotmail.com,(075)141-3004x3250,,Cody Hammond,0238 John Path Suite 304,7-17 LATONA ROAD,LONDON,,SE15 6RY,United Kingdom,GB,1/28/20,,United Kingdom,GB,,LONDON,,
573,1/22/20 11:38am,Bandcamp,album,Terrouzi,Ahmedou Ahmed Lowla,USD,7.0,1.0,,7.0,1.4,,,,,8.4,0.0,3177458495,,0.7,9.2,0.0,119.97,376.75,6.3,digital download,,http://ahmedouahmedlowla.bandcamp.com/album/terrouzi,,SS-054,602318 137029,,Calvin Hopkins,bryan87@hotmail.com,001-731-509-0463x862,,Pam Anderson,526 Brian Common,7-17 LATONA ROAD,LONDON,,SE15 6RY,,,,,United Kingdom,GB,Lewisham,,,
574,1/22/20 11:40am,Bandcamp,package,Tiris,El Wali,USD,17.0,1.0,,17.0,,23.0,United States,1.46,paypal,40.0,0.0,527675404,,1.7,1.7,0.0,36.84,413.59,13.84,Tiris LP,,http://elwali.bandcamp.com/album/tiris,SS-055lp,SS-055,602318 136923,,Walter Wright,owilson@hotmail.com,001-984-480-4632x95943,,Tammy Aguirre,4517 Henson Junctions,,Ingleburn,NSW,2565,Australia,AU,1/28/20,,Australia,AU,NSW,Ingleburn,youtube.com,www.youtube.com/
575,1/22/20 1:36pm,Bandcamp,album,Music from Saharan WhatsApp,Etran de L'Aïr,USD,3.0,1.0,,3.0,,,,0.2,paypal,3.0,0.0,1889354421,,0.3,0.3,0.0,2.5,416.09,2.5,digital download,,http://etrandelair.bandcamp.com/album/music-from-saharan-whatsapp,,WHATSAPP-01,,,Heather Daniel,crystal20@davidson.com,001-704-868-8256x05469,,Shirley Marshall,3924 Fuentes Mill Apt. 220,,,,,,,,,United States,US,PA,Sellersville,,
576,1/22/20 1:38pm,Bandcamp,album,Music from Saharan WhatsApp,Etran de L'Aïr,USD,1.0,1.0,,1.0,,,,0.11,credit card,1.0,0.0,3768609287,,0.1,0.1,0.0,0.79,416.88,0.79,digital download,,http://etrandelair.bandcamp.com/album/music-from-saharan-whatsapp,,WHATSAPP-01,,,Tracy Smith,andrewschristopher@yahoo.com,001-166-746-6530x2743,,Stacy Oneill,537 White Freeway Apt. 415,,,,,,,,,Poland,PL,Lublin,Poniatowa,Bandcamp fan page: wujekb,bandcamp.com/wujekb
577,1/22/20 3:42pm,Bandcamp,album,Tiris,El Wali,USD,7.0,1.0,,7.0,1.33,,,0.69,paypal,8.33,0.0,1702118465,,0.7,0.0,0.7,0.0,416.88,5.61,digital download,,http://elwali.bandcamp.com/album/tiris,,SS-055,602318 136923,,Jaime Carter,dwright@hotmail.com,398.336.7593,,Evan Lane,53224 Forbes Court Apt. 947,,,,,,,,,Germany,DE,Lower Saxony,Zeven,,
578,1/22/20 3:42pm,Bandcamp,album,Music from Saharan WhatsApp,Etran de L'Aïr,USD,5.0,1.0,,5.0,,,,,,5.0,0.0,1702118465,,0.5,1.2,0.0,10.11,426.99,4.5,digital download,,http://etrandelair.bandcamp.com/album/music-from-saharan-whatsapp,,WHATSAPP-01,,,Jaime Carter,meyerandrew@acosta.com,(668)509-8969,,Christian Sanchez,1929 Garcia Terrace,,,,,,,,,Germany,DE,Lower Saxony,Zeven,,
579,1/22/20 4:57pm,Bandcamp,album,Music from Saharan WhatsApp,Etran de L'Aïr,USD,1.0,1.0,,1.0,,,,0.1,paypal,1.0,0.0,4107928836,,0.1,0.1,0.0,0.8,427.79,0.8,digital download,,http://etrandelair.bandcamp.com/album/music-from-saharan-whatsapp,,WHATSAPP-01,,,Kevin Young,markhawkins@yahoo.com,(643)545-2702x1828,,Monique Moore,5393 Lee Ville,,,,,,,,,United States,US,NY,Wappingers Falls,Bandcamp weekly newsletter,bandcamp.com
580,1/22/20 5:09pm,Bandcamp,album,Music from Saharan WhatsApp,Etran de L'Aïr,USD,3.0,1.0,,3.0,,,,0.2,paypal,3.0,0.0,661862253,,0.3,0.3,0.0,2.5,430.29,2.5,digital download,,http://etrandelair.bandcamp.com/album/music-from-saharan-whatsapp,,WHATSAPP-01,,,Melissa Lewis,kristen70@yahoo.com,001-701-936-7074,,Joseph Johnston,6989 Acosta Vista,,,,,,,,,United States,US,OH,Cleveland,,
581,1/22/20 6:02pm,shop@sahelsounds.com,payout,,,USD,,,,,,,,0.76,transfer,75.56,74.8,t253108773,9W338513YY325393P,,,,-75.56,354.73,,,,,,,,,,,,,,,,,,,,,,,,,,,,
582,1/22/20 6:03pm,shop@sahelsounds.com,payout,,,USD,,,,,,,,0.23,transfer,23.09,22.86,t253108775,3LE49266GC783240B,,,,-23.09,331.64,,,,,,,,,,,,,,,,,,,,,,,,,,,,
583,1/22/20 6:43pm,Bandcamp,album,Music from Saharan WhatsApp,Etran de L'Aïr,USD,5.0,1.0,,5.0,,,,0.3,paypal,5.0,0.0,639674689,,0.5,0.5,0.0,4.2,335.84,4.2,digital download,,http://etrandelair.bandcamp.com/album/music-from-saharan-whatsapp,,WHATSAPP-01,,,Michelle Harper,caitlinpowell@ross-lynch.com,725-517-2509x1645,,Brittany Gutierrez,41598 Diaz Via,,,,,,,,,United States,US,KY,Lexington,Bandcamp search,bandcamp.com/app/ios/search
584,1/22/20 6:49pm,Bandcamp,album,Music from Saharan WhatsApp,Etran de L'Aïr,USD,10.0,1.0,,10.0,,,,0.59,paypal,10.0,0.0,1159485497,,1.0,1.0,0.0,8.41,344.25,8.41,digital download,,http://etrandelair.bandcamp.com/album/music-from-saharan-whatsapp,,WHATSAPP-01,,,Gerald Payne,john00@warner-stephens.biz,3156524197,,Tiffany Wright,735 Jason Ford,,,,,,,,,Mexico,MX,Mexico City,Mexico City,Publish notice sent to your fans,
585,1/22/20 7:47pm,Bandcamp,album,Music from Saharan WhatsApp,Etran de L'Aïr,USD,7.0,1.0,,7.0,,,,0.47,credit card,7.0,0.0,963178426,,0.7,0.7,0.0,5.83,350.08,5.83,digital download,,http://etrandelair.bandcamp.com/album/music-from-saharan-whatsapp,,WHATSAPP-01,,,Laura Morris,michael50@hotmail.com,(891)872-5094x8960,,Gregory Flores,330 Jeffrey Fields Apt. 403,,,,,,,,,United Kingdom,GB,Peterborough,Peterborough,Bandcamp search,bandcamp.com/app/android/search
586,1/22/20 11:38pm,Bandcamp,album,Music from Saharan WhatsApp,Etran de L'Aïr,USD,5.0,1.0,,5.0,,,,0.35,paypal,5.0,0.0,1040204633,,0.5,0.5,0.0,4.15,354.23,4.15,digital download,,http://etrandelair.bandcamp.com/album/music-from-saharan-whatsapp,,WHATSAPP-01,,,Jeffrey Johnston,brianhamilton@moore.com,087.358.0293,,Darlene Martinez,5071 Cooper Stravenue,,,,,,,,,Canada,CA,ON,Toronto,,
587,1/23/20 12:13am,Bandcamp,album,Music from Saharan WhatsApp,Etran de L'Aïr,USD,10.0,1.0,,10.0,,,,0.49,paypal,10.0,0.0,2687052450,,1.0,1.0,0.0,8.51,362.74,8.51,digital download,,http://etrandelair.bandcamp.com/album/music-from-saharan-whatsapp,,WHATSAPP-01,,,Shannon Robinson,sabrinahunt@simpson.info,6133540625,,Joel Cuevas,70491 Nicole Via Suite 516,,,,,,,,,United States,US,OH,Cleveland,,
588,1/23/20 1:40am,Bandcamp,album,Music from Saharan WhatsApp,Etran de L'Aïr,USD,4.0,1.0,,4.0,,,,0.25,paypal,4.0,0.0,83388263,,0.4,0.4,0.0,3.35,366.09,3.35,digital download,,http://etrandelair.bandcamp.com/album/music-from-saharan-whatsapp,,WHATSAPP-01,,,Jonathan Reed,quinnmichael@hotmail.com,001-096-024-8568,,Kevin Nelson,44753 Erin Skyway Apt. 860,,,,,,,,,United States,US,,,,
589,1/23/20 8:47am,Bandcamp,album,Eghass Malan,Les Filles de Illighadad,USD,7.0,1.0,,7.0,,,,0.47,credit card,7.0,0.0,181784276,,0.7,0.7,0.0,5.83,371.92,5.83,digital download,,http://lesfillesdeillighadad.bandcamp.com/album/eghass-malan,,SS-044,191515 928351,,Susan Diaz,smithjohn@gmail.com,927.046.8791x12137,,Gloria Chavez,4246 Everett Via Suite 528,,,,,,,,,Congo (Kinshasa),CD,Kinshasa City,Kinshasa,Bandcamp Daily: les-filles-de-illighadad-eghass-malan-review,daily.bandcamp.com/album-of-the-day/les-filles-de-illighadad-eghass-malan-review
590,1/23/20 11:47am,Bandcamp,album,Music from Saharan WhatsApp,Etran de L'Aïr,USD,1.0,1.0,,1.0,,,,0.1,paypal,1.0,0.0,2579675967,,0.1,0.1,0.0,0.8,372.72,0.8,digital download,,http://etrandelair.bandcamp.com/album/music-from-saharan-whatsapp,,WHATSAPP-01,,,Kelsey Abbott,kathleenrussell@walker-stone.org,0862981636,,Nicholas Cardenas,84160 Cole Course,,,,,,,,,United States,US,NY,Rhinebeck,Bandcamp search,bandcamp.com/autocomplete-search
591,1/23/20 6:03pm,shop@sahelsounds.com,payout,,,USD,,,,,,,,2.87,transfer,287.18,284.31,t253339911,8UK18634SP554914J,,,,-287.18,85.54,,,,,,,,,,,,,,,,,,,,,,,,,,,,
592,1/23/20 6:03pm,shop@sahelsounds.com,payout,,,USD,,,,,,,,0.44,transfer,44.46,44.02,t253339915,3JY56888855579434,,,,-44.46,41.08,,,,,,,,,,,,,,,,,,,,,,,,,,,,
593,1/23/20 7:20pm,Bandcamp,album,Music from Saharan WhatsApp,Etran de L'Aïr,USD,2.0,1.0,,2.0,,,,0.17,paypal,2.0,0.0,663518989,,0.2,0.2,0.0,1.63,42.71,1.63,digital download,,http://etrandelair.bandcamp.com/album/music-from-saharan-whatsapp,,WHATSAPP-01,,,Johnathan Perez,elizabethjones@atkins-scott.net,962-706-4822x39052,,Jose Craig,331 Camacho Vista,,,,,,,,,Germany,DE,North Rhine-Westphalia,Furth,Bandcamp music feed,http://blog.bandcamp.com/2013/09/19/strap-on-your-feed-bag/
594,1/23/20 7:21pm,Bandcamp,album,Ilana: The Creator,Mdou Moctar,USD,7.0,1.0,,7.0,1.47,,,0.57,credit card,8.47,0.0,3618707,,0.7,0.7,0.0,5.73,48.44,5.73,digital download,,http://mdoumoctar.bandcamp.com/album/ilana-the-creator,,SS-051,602318 136893,,Michael Campbell,rebekahfranklin@schmidt.info,844.875.2028x8718,,Darren Carson,3311 Sparks Curve Apt. 739,,,,,,,,,Belgium,BE,Liège Province,Herstal,Bandcamp search: “modou moctar”,bandcamp.com/search?q=modou%20moctar
595,1/23/20 8:05pm,Bandcamp,album,Agrim Agadez,Various,USD,7.0,1.0,,7.0,,,,0.4,credit card,7.0,0.0,823528655,,0.7,0.7,0.0,5.9,54.34,5.9,digital download,,http://sahelsounds.bandcamp.com/album/agrim-agadez,,SS-038,889326 872382,,Kenneth Harris,bethany04@yahoo.com,(330)826-1593x77559,,Dorothy Holland,03465 Lawrence Corner,,,,,,,,,United States,US,CA,Costa Mesa,sahelsounds.com (embedded player),sahelsounds.com/2017/01/agrim-agadez/
596,1/23/20 11:25pm,Bandcamp,album,Ilana: The Creator,Mdou Moctar,USD,10.0,1.0,,10.0,,,,0.88,paypal,10.0,0.0,2764929271,,1.0,0.0,1.0,0.0,54.34,8.12,digital download,,http://mdoumoctar.bandcamp.com/album/ilana-the-creator,,SS-051,602318 136893,,Angela Osborne,smithcole@parker.org,(530)849-2643,"I randomly found and heard your music, Mdou and was captivated. So here I am... Extending that pleasure, that joy!  Thanks for your music!",Bryce Dunn,613 Heather Mountains,,,,,,,,,Chile,CL,Santiago Metropolitan,Las Condes,Bandcamp artist: mdoumoctar,mdoumoctar.bandcamp.com
597,1/23/20 11:25pm,Bandcamp,album,Sousoume Tamachek,Mdou Moctar,USD,10.0,1.0,,10.0,,,,,,10.0,0.0,2764929271,,1.0,2.0,0.0,17.12,71.46,9.0,digital download,,http://mdoumoctar.bandcamp.com/album/sousoume-tamachek,,SS-043,191515 769435,,Angela Osborne,awright@hotmail.com,0328448359,,Lori Hensley,95484 Robinson Mission,,,,,,,,,Chile,CL,Santiago Metropolitan,Las Condes,Bandcamp artist: mdoumoctar,mdoumoctar.bandcamp.com
598,1/23/20 11:41pm,Bandcamp,album,Eghass Malan,Les Filles de Illighadad,USD,7.0,1.0,,7.0,1.61,,,0.55,paypal,8.61,0.0,1235251185,,0.7,0.7,0.0,5.75,77.21,5.75,digital download,,http://lesfillesdeillighadad.bandcamp.com/album/eghass-malan,,SS-044,191515 928351,,Bethany Smith,murraypatrick@gordon-collier.com,8371755917,,Vanessa Barnes,302 Williams Manors,,,,,,,,,Ireland,IE,County Tipperary,Clonmel,,
599,1/24/20 12:07am,Bandcamp,album,Music from Saharan WhatsApp,Etran de L'Aïr,USD,5.0,1.0,,5.0,,,,0.35,paypal,5.0,0.0,2154926703,,0.5,0.5,0.0,4.15,81.36,4.15,digital download,,http://etrandelair.bandcamp.com/album/music-from-saharan-whatsapp,,WHATSAPP-01,,,Eric Macdonald,melissamclaughlin@gmail.com,(751)941-8964x54320,,Anthony Gill,0967 Kyle Trace Suite 348,,,,,,,,,United Kingdom,GB,Swindon,Swindon,Bandcamp home page,bandcamp.com/
600,1/24/20 3:36am,Bandcamp,album,Hali Diallo,Tallawit Timbouctou,USD,7.0,1.0,,7.0,,,,0.47,credit card,7.0,0.0,1439218082,,0.7,0.7,0.0,5.83,87.19,5.83,digital download,,http://tallawit.bandcamp.com/album/hali-diallo,,SS-048,656605 382265,,Richard Collins,amanda49@gmail.com,(261)382-4588,,Christian King,9025 Philip Track,,,,,,,,,Australia,AU,NSW,Newtown,Bandcamp fan page: stuart_buchanan,bandcamp.com/stuart_buchanan
601,1/24/20 8:19am,Bandcamp,album,Balani Show Super Hits: Electronic Street Parties from Mali,Various,USD,8.0,1.0,,8.0,1.4,,,0.57,paypal,9.4,0.0,730454615,,0.8,0.8,0.0,6.63,93.82,6.63,digital download,,http://sahelsounds.bandcamp.com/album/balani-show-super-hits-electronic-street-parties-from-mali,,SS-021,889326 667643,,Whitney Marshall,tracykerr@jackson.com,065.229.8795,,Joshua Parsons,1035 Nichols Ville,,,,,,,,,France,FR,Paris,Paris,Bandcamp search: “kaba blon”,bandcamp.com/search?q=kaba%20blon
602,1/24/20 11:46am,Bandcamp,album,Music from Saharan WhatsApp,Etran de L'Aïr,USD,3.0,1.0,,3.0,,,,0.23,credit card,3.0,0.0,2286333833,,0.3,0.3,0.0,2.47,96.29,2.47,digital download,,http://etrandelair.bandcamp.com/album/music-from-saharan-whatsapp,,WHATSAPP-01,,,Teresa Johnson,jessicaray@hotmail.com,+1-702-830-3400x247,,Amy Stanton,4726 Keith Squares,,,,,,,,,Poland,PL,Mazovia,Warsaw,,
603,1/24/20 1:19pm,Bandcamp,album,Music from Saharan WhatsApp,Etran de L'Aïr,USD,4.0,1.0,,4.0,,,,0.29,paypal,4.0,0.0,754503469,,0.4,0.4,0.0,3.31,99.6,3.31,digital download,,http://etrandelair.bandcamp.com/album/music-from-saharan-whatsapp,,WHATSAPP-01,,,Tiffany Thompson,kevintorres@brennan.org,510-081-6963x094,,Troy Charles,875 Christopher Locks,,,,,,,,,Denmark,DK,Capital Region,Copenhagen,Facebook,l.facebook.com
604,1/24/20 2:42pm,Bandcamp,album,Music from Saharan WhatsApp,Etran de L'Aïr,USD,1.0,1.0,,1.0,,,,0.11,credit card,1.0,0.0,3706520676,,0.1,0.1,0.0,0.79,100.39,0.79,digital download,,http://etrandelair.bandcamp.com/album/music-from-saharan-whatsapp,,WHATSAPP-01,,,Carla Gonzalez,dawn64@yahoo.com,988-743-2842x771,,Derek Tran,4207 Erica Fields Suite 352,,,,,,,,,Poland,PL,Mazovia,Warsaw,Bandcamp Discover,bandcamp.com/#discover
605,1/24/20 4:08pm,Bandcamp,album,Music from Saharan WhatsApp,Etran de L'Aïr,USD,5.0,1.0,,5.0,,,,0.3,paypal,5.0,0.0,68873751,,0.5,0.5,0.0,4.2,104.59,4.2,digital download,,http://etrandelair.bandcamp.com/album/music-from-saharan-whatsapp,,WHATSAPP-01,,,Monica Freeman,itownsend@bartlett-bell.com,+1-570-788-0856x2712,,Joshua Patrick,75329 Hartman Radial Suite 286,,,,,,,,,United States,US,RI,Barrington,Publish notice sent to your fans,
606,1/24/20 6:02pm,shop@sahelsounds.com,payout,,,USD,,,,,,,,0.17,transfer,16.92,16.75,t253611500,2W212024TF868245X,,,,-16.92,87.67,,,,,,,,,,,,,,,,,,,,,,,,,,,,
607,1/24/20 6:02pm,shop@sahelsounds.com,payout,,,USD,,,,,,,,0.24,transfer,24.16,23.92,t253611501,98867480G2269173U,,,,-24.16,63.51,,,,,,,,,,,,,,,,,,,,,,,,,,,,
608,1/24/20 6:16pm,Bandcamp,album,Sousoume Tamachek,Mdou Moctar,USD,7.0,1.0,,7.0,1.33,,,0.83,credit card,8.33,0.0,2766159210,,0.7,0.0,0.7,0.0,63.51,5.47,digital download,,http://mdoumoctar.bandcamp.com/album/sousoume-tamachek,,SS-043,191515 769435,,Alisha Sharp,whitney53@williams-meza.biz,004-905-5519x669,,Tracey Hayes,8982 Loretta Unions,,,,,,,,,Germany,DE,Baden-Württemberg,Tamm,Bandcamp home page,bandcamp.com/
609,1/24/20 6:16pm,Bandcamp,album,Ilana: The Creator,Mdou Moctar,USD,7.0,1.0,,7.0,1.33,,,,,8.33,0.0,2766159210,,0.7,1.4,0.0,11.77,75.28,6.3,digital download,,http://mdoumoctar.bandcamp.com/album/ilana-the-creator,,SS-051,602318 136893,,Alisha Sharp,robinsonjeffrey@hotmail.com,4517790895,,Rebecca Townsend,0345 Sophia Lodge,,,,,,,,,Germany,DE,Baden-Württemberg,Tamm,Bandcamp home page,bandcamp.com/
610,1/24/20 7:05pm,Bandcamp,album,Akounak Tedalat Taha Tazoughai OST,Mdou Moctar,USD,7.0,1.0,,7.0,1.33,,,0.78,paypal,8.33,0.0,975425341,,0.7,0.0,0.7,0.0,75.28,5.52,digital download,,http://mdoumoctar.bandcamp.com/album/akounak-tedalat-taha-tazoughai-ost,,SS-028,889326 667599,,Jesse Williams,patricia83@hotmail.com,(025)642-0768x33769,,Chad Powers,760 Tara Club Apt. 126,,,,,,,,,Germany,DE,Baden-Württemberg,Stuttgart,Bandcamp fan page: spacecowgirl,bandcamp.com/spacecowgirl
611,1/24/20 7:05pm,Bandcamp,album,Les Filles de Illighadad,Les Filles de Illighadad,USD,7.0,1.0,,7.0,1.33,,,,,8.33,0.0,975425341,,0.7,1.4,0.0,11.82,87.1,6.3,digital download,,http://lesfillesdeillighadad.bandcamp.com/album/les-filles-de-illighadad,,SS-033,889326 664918,,Jesse Williams,angela99@calhoun.biz,601.334.8851x6852,,Joseph Drake,4602 Lowe Stream Apt. 663,,,,,,,,,Germany,DE,Baden-Württemberg,Stuttgart,Bandcamp: spacecowgirl/following/artists_and_labels,bandcamp.com/spacecowgirl/following/artists_and_labels
612,1/24/20 7:28pm,Bandcamp,album,Music from Saharan WhatsApp,Etran de L'Aïr,USD,1.0,1.0,,1.0,,,,0.11,paypal,1.0,0.0,1740072906,,0.1,0.1,0.0,0.79,87.89,0.79,digital download,,http://etrandelair.bandcamp.com/album/music-from-saharan-whatsapp,,WHATSAPP-01,,,Victoria Johnson,richardsonjacob@yahoo.com,462-430-5524,,Patrick Smith,514 Robert Estates,,,,,,,,,France,FR,Paris,Paris,Bandcamp fan wishlist,bandcamp.com/tingyun
613,1/24/20 10:46pm,Bandcamp,album,Music from Saharan WhatsApp,Etran de L'Aïr,USD,2.0,1.0,,2.0,,,,0.15,paypal,2.0,0.0,3961445670,,0.2,0.2,0.0,1.65,89.54,1.65,digital download,,http://etrandelair.bandcamp.com/album/music-from-saharan-whatsapp,,WHATSAPP-01,,,Patricia Robinson,douglasgriffin@gmail.com,732.102.5032,,Richard Simpson,17048 Harris Squares Apt. 309,,,,,,,,,United States,US,WI,,,
614,1/24/20 11:01pm,Bandcamp,package,Sahel Sounds Label Sampler,Various Artists,USD,20.0,1.0,,20.0,,5.0,United States,0.85,credit card,25.0,0.0,3270486875,,2.0,2.0,0.0,22.15,111.69,17.15,Sahel Sounds t-shirt,Large,http://sahelsounds.bandcamp.com/merch/sahel-sounds-t-shirt,SS-T01-BLK-ULG,,,,Tyler Willis,wesleyhuff@hobbs-jackson.net,+1-142-998-0870x642,,Charles Smith,343 Alex Dam Suite 878,9 Lomas dr.,durango,CO,81301,United States,US,,,United States,US,CO,durango,Google search,www.google.com/
615,1/24/20 11:33pm,Bandcamp,album,Music from Saharan WhatsApp,Etran de L'Aïr,USD,1.0,1.0,,1.0,,,,0.11,paypal,1.0,0.0,3908565390,,0.1,0.1,0.0,0.79,112.48,0.79,digital download,,http://etrandelair.bandcamp.com/album/music-from-saharan-whatsapp,,WHATSAPP-01,,,William Woodward,jennifer13@rivera.com,009.080.8232,,Sara Goodman,52628 Lindsay Throughway,,,,,,,,,United Kingdom,GB,,,Bandcamp search,bandcamp.com/app/android/search
616,1/24/20 11:57pm,Bandcamp,album,Ilana: The Creator,Mdou Moctar,USD,7.0,1.0,,7.0,1.4,,,0.54,paypal,8.4,0.0,346543730,,0.7,0.7,0.0,5.76,118.24,5.76,digital download,,http://mdoumoctar.bandcamp.com/album/ilana-the-creator,,SS-051,602318 136893,,Leslie Gates,tylerwest@austin-arellano.info,763.043.3738x928,,Joseph Gray,49386 Brandon Plaza,,,,,,,,,United Kingdom,GB,East Sussex,Wych Cross,Google search,www.google.com/
617,1/25/20 2:48am,Bandcamp,album,Eghass Malan,Les Filles de Illighadad,USD,7.0,1.0,,7.0,,,,0.47,paypal,7.0,0.0,831082476,,0.7,0.7,0.0,5.83,124.07,5.83,digital download,,http://lesfillesdeillighadad.bandcamp.com/album/eghass-malan,,SS-044,191515 928351,,Katelyn Jensen,beltranruben@martinez.org,6622533269,,Jill Lopez,381 Church Underpass,,,,,,,,,Australia,AU,VIC,Melbourne,Bandcamp search,bandcamp.com/app/ios/search
618,1/25/20 3:16am,Bandcamp,album,Ilana: The Creator,Mdou Moctar,USD,7.0,1.0,,7.0,,,,0.4,credit card,7.0,0.0,2934999229,,0.7,0.7,0.0,5.9,129.97,5.9,digital download,,http://mdoumoctar.bandcamp.com/album/ilana-the-creator,,SS-051,602318 136893,,Amy Green,melissahernandez@howard.com,001-953-836-6619x766,,Lauren Mathews,8635 Judy Mountains Apt. 904,,,,,,,,,United States,US,AZ,Tempe,Bandcamp fan page: tristonwave4200,bandcamp.com/tristonwave4200
619,1/25/20 4:58am,Bandcamp,album,Music from Saharan WhatsApp,Etran de L'Aïr,USD,6.0,1.0,,6.0,,,,0.35,paypal,6.0,0.0,4106940075,,0.6,0.6,0.0,5.05,135.02,5.05,digital download,,http://etrandelair.bandcamp.com/album/music-from-saharan-whatsapp,,WHATSAPP-01,,,Brandon Rivera,salazarangela@carter-cook.com,847.430.0932x904,,William Henry,656 Wilson Coves Apt. 052,,,,,,,,,United States,US,NY,Brooklyn,Bandcamp weekly newsletter,bandcamp.com
620,1/25/20 5:18am,Bandcamp,album,Les Filles de Illighadad,Les Filles de Illighadad,USD,7.0,1.0,,7.0,,,,0.61,credit card,7.0,0.0,3221281675,,0.7,0.0,0.7,0.0,135.02,5.69,digital download,,http://lesfillesdeillighadad.bandcamp.com/album/les-filles-de-illighadad,,SS-033,889326 664918,,Chad Hammond,laurenlee@smith.com,+1-239-709-5345,,Heather Barrett,24092 Keith Island Suite 592,,,,,,,,,United States,US,VT,Essex Junction,Bandcamp fan wishlist,bandcamp.com/ericext
621,1/25/20 5:18am,Bandcamp,album,Eghass Malan,Les Filles de Illighadad,USD,7.0,1.0,,7.0,,,,,,7.0,0.0,3221281675,,0.7,1.4,0.0,11.99,147.01,6.3,digital download,,http://lesfillesdeillighadad.bandcamp.com/album/eghass-malan,,SS-044,191515 928351,,Chad Hammond,tiffanycampbell@hotmail.com,(030)765-1946,,Caitlin Hunter,3801 Fox Flat Apt. 195,,,,,,,,,United States,US,VT,Essex Junction,Bandcamp fan wishlist,bandcamp.com/ericext
622,1/25/20 2:36pm,Bandcamp,album,Music from Saharan WhatsApp,Etran de L'Aïr,USD,2.0,1.0,,2.0,,,,0.15,paypal,2.0,0.0,3392121825,,0.2,0.2,0.0,1.65,148.66,1.65,digital download,,http://etrandelair.bandcamp.com/album/music-from-saharan-whatsapp,,WHATSAPP-01,,,Cameron Jackson,harrismaria@gmail.com,001-185-388-3644x94650,,Jacob Rogers,0386 Adams Common Suite 465,,,,,,,,,United States,US,NJ,Pine Brook,Publish notice sent to your fans,
623,1/25/20 3:04pm,Bandcamp,package,La Musique Electronique du Niger,Mamman Sani,USD,12.0,1.0,,12.0,,4.0,United States,0.65,credit card,16.0,0.0,3020278694,,1.2,1.2,0.0,14.15,162.81,10.15,Mamman Sani CD,,http://mammansani.bandcamp.com/album/la-musique-electronique-du-niger,SS-011cd,SS-011,889326 664864,,Cassandra Anderson,wilkinsonmelissa@campbell.biz,001-090-159-4070,,Carol Wood,8041 Johnathan Turnpike Apt. 768,,WASHINGTON,DC,20015,United States,US,1/28/20,,United States,US,DC,WASHINGTON,,
624,1/25/20 4:12pm,Bandcamp,album,Ilana: The Creator,Mdou Moctar,USD,7.0,1.0,,7.0,,,,0.4,gift card,7.0,0.0,3797099124,,0.7,0.7,0.0,5.9,168.71,5.9,digital download,,http://mdoumoctar.bandcamp.com/album/ilana-the-creator,,SS-051,602318 136893,,Veronica Mcguire,juanford@hall.info,419-523-7084x78545,,Tony Douglas,099 Mathis Extensions Apt. 970,,,,,,,,,United States,US,NC,Greensboro,Bandcamp search,bandcamp.com/autocomplete-search
625,1/25/20 4:23pm,Bandcamp,album,Torodi,Hama,USD,10.0,1.0,,10.0,,,,0.49,paypal,10.0,0.0,2262190750,,1.0,1.0,0.0,8.51,177.22,8.51,digital download,,http://hamasynth.bandcamp.com/album/torodi,,SS-025,889326 664833,,David Sampson,othornton@hotmail.com,001-832-885-5494x85611,,Henry Lambert,3751 David Dam Apt. 620,,,,,,,,,United States,US,OR,Portland,,
626,1/25/20 5:44pm,Bandcamp,album,Ilana: The Creator,Mdou Moctar,USD,7.0,1.0,,7.0,,,,0.47,credit card,7.0,0.0,368659182,,0.7,0.7,0.0,5.83,183.05,5.83,digital download,,http://mdoumoctar.bandcamp.com/album/ilana-the-creator,,SS-051,602318 136893,,Katherine Williams,smartinez@peters.com,+1-724-236-7012x47838,,Jonathan Myers,929 Kayla Ford Suite 180,,,,,,,,,Canada,CA,ON,Vaughan,shop.sahelsounds.com,shop.sahelsounds.com/products/mdou-moctar-ilana-the-creator
627,1/25/20 6:02pm,shop@sahelsounds.com,payout,,,USD,,,,,,,,0.28,transfer,28.28,28.0,t253885730,8S420942U7372483A,,,,-28.28,154.77,,,,,,,,,,,,,,,,,,,,,,,,,,,,
628,1/25/20 6:03pm,shop@sahelsounds.com,payout,,,USD,,,,,,,,0.35,transfer,35.23,34.88,t253885729,7C1248490U5680242,,,,-35.23,119.54,,,,,,,,,,,,,,,,,,,,,,,,,,,,
629,1/25/20 6:41pm,Bandcamp,album,Anar,Mdou Moctar,USD,7.0,1.0,,7.0,,,,0.4,paypal,7.0,0.0,4170600677,,0.7,0.7,0.0,5.9,125.44,5.9,digital download,,http://mdoumoctar.bandcamp.com/album/anar,,SS-024,889326 664857,,Matthew Irwin,cole19@wilson-blanchard.com,001-794-082-9837x499,,William Barrett,66716 Bishop Park Apt. 860,,,,,,,,,United States,US,CA,Los Angeles,Google search,www.google.com/
630,1/25/20 7:25pm,Bandcamp,album,Music from Saharan WhatsApp,Etran de L'Aïr,USD,3.0,1.0,,3.0,,,,0.23,paypal,3.0,0.0,3213098377,,0.3,0.3,0.0,2.47,127.91,2.47,digital download,,http://etrandelair.bandcamp.com/album/music-from-saharan-whatsapp,,WHATSAPP-01,,,Julie Hernandez,bhill@fitzpatrick-herrera.biz,4594508641,,Joseph Edwards,6117 Thompson Knoll,,,,,,,,,Germany,DE,Saxony,Dresden,Recommendations footer: new and notable,bandcamp.com/footer/nn/a1550838743
631,1/25/20 8:35pm,Bandcamp,album,Music from Saharan WhatsApp,Etran de L'Aïr,USD,1.0,1.0,,1.0,,,,0.11,credit card,1.0,0.0,1098159257,,0.1,0.1,0.0,0.79,128.7,0.79,digital download,,http://etrandelair.bandcamp.com/album/music-from-saharan-whatsapp,,WHATSAPP-01,,,Michelle Bruce,nmartin@hotmail.com,001-699-746-2286x9684,,Sandra Barker,9961 Woodward Crossroad,,,,,,,,,Portugal,PT,Porto,Penafiel,Bandcamp fan wishlist,bandcamp.com/TERUMANIA
632,1/25/20 9:31pm,Bandcamp,album,Music from Saharan WhatsApp,Etran de L'Aïr,USD,5.0,1.0,,5.0,,,,0.3,paypal,5.0,0.0,517699822,,0.5,0.5,0.0,4.2,132.9,4.2,digital download,,http://etrandelair.bandcamp.com/album/music-from-saharan-whatsapp,,WHATSAPP-01,,,Sylvia Yu,belltanya@hotmail.com,(925)459-1606,,Peggy Chavez,2764 Cruz Knoll Suite 986,,,,,,,,,United States,US,IL,Chicago,Bandcamp fan wishlist,bandcamp.com/kyleaeby
633,1/25/20 10:16pm,Bandcamp,album,Music from Saharan WhatsApp,Etran de L'Aïr,USD,10.0,1.0,,10.0,,,,0.49,paypal,10.0,0.0,1376465648,,1.0,1.0,0.0,8.51,141.41,8.51,digital download,,http://etrandelair.bandcamp.com/album/music-from-saharan-whatsapp,,WHATSAPP-01,,,Gregory Henderson,sandra31@cunningham.com,(882)464-7787,,Alexander Garcia,04934 Brown Walk Apt. 797,,,,,,,,,United States,US,GA,Atlanta,,
634,1/26/20 1:26am,Bandcamp,package,Ilana: The Creator,Mdou Moctar,USD,17.0,1.0,,17.0,,5.0,United States,0.78,credit card,22.0,0.0,3563464039,,1.7,1.7,0.0,19.52,160.93,14.52,Ilana LP,,http://mdoumoctar.bandcamp.com/album/ilana-the-creator,SS-051lp,SS-051,602318 136893,,Charles Guerrero,ghowell@gmail.com,114.412.3422,,Brandon King,82163 James Hills Suite 290,,Ventura,CA,93006,United States,US,1/28/20,,United States,US,CA,Ventura,Google search,www.google.com/
635,1/26/20 3:24pm,Bandcamp,package,Zerzura (Original Soundtrack Recording),Ahmoudou Madassane,USD,15.0,1.0,,15.0,,10.0,United States,1.03,paypal,25.0,0.0,1221878178,,1.5,1.5,0.0,22.47,183.4,12.47,Zerzura DVD,,http://sahelsounds.bandcamp.com/merch/zerzura-dvd,SS-046DVD,,,,John King,elizabeth35@hotmail.com,1447177256,,Sarah Collins,151 Timothy Stravenue Apt. 254,Woodville,Swadlincote,,DE11 7HY,United Kingdom,GB,1/28/20,,United Kingdom,GB,,Swadlincote,Bandcamp artist: sahelsounds,sahelsounds.bandcamp.com/merch/zerzura-dvd
636,1/26/20 3:28pm,Bandcamp,album,Balani Show Super Hits: Electronic Street Parties from Mali,Various,USD,7.0,1.0,,7.0,1.47,,,0.57,credit card,8.47,0.0,3761027579,,0.7,0.7,0.0,5.73,189.13,5.73,digital download,,http://sahelsounds.bandcamp.com/album/balani-show-super-hits-electronic-street-parties-from-mali,,SS-021,889326 667643,,Jaclyn Weber,andrea17@hotmail.com,(554)671-8272x9486,,John Diaz,15475 Bolton Haven Suite 202,,,,,,,,,Netherlands,NL,North Holland,Amsterdam,youtube.com,www.youtube.com/
637,1/26/20 3:46pm,Bandcamp,album,Taaritt,Mamman Sani,USD,7.0,1.0,,7.0,,,,0.4,credit card,7.0,0.0,1345621060,,0.7,0.7,0.0,5.9,195.03,5.9,digital download,,http://mammansani.bandcamp.com/album/taaritt,,SS-023,889326 664871,,Luke Hart,jonathan04@watson-bailey.com,804-999-2335x3761,,Jonathan Short,765 Shawn Divide Apt. 385,,,,,,,,,United States,US,VA,Staunton,Google search,www.google.com/
638,1/26/20 4:52pm,Bandcamp,album,Music from Saharan WhatsApp,Etran de L'Aïr,USD,1.0,1.0,,1.0,,,,0.11,paypal,1.0,0.0,3382059088,,0.1,0.1,0.0,0.79,195.82,0.79,digital download,,http://etrandelair.bandcamp.com/album/music-from-saharan-whatsapp,,WHATSAPP-01,,,David Castro,moranjohn@lee.com,(022)778-6004x057,,Monique Shaw,570 Cynthia Union,,,,,,,,,Poland,PL,Mazovia,Warsaw,Bandcamp search,bandcamp.com/app/android/search
639,1/26/20 6:03pm,shop@sahelsounds.com,payout,,,USD,,,,,,,,0.92,transfer,92.05,91.13,t254122835,04J87006FK4788031,,,,-92.05,103.77,,,,,,,,,,,,,,,,,,,,,,,,,,,,
640,1/26/20 6:03pm,shop@sahelsounds.com,payout,,,USD,,,,,,,,0.27,transfer,27.49,27.22,t254122831,7FL7957784082031P,,,,-27.49,76.28,,,,,,,,,,,,,,,,,,,,,,,,,,,,
641,1/26/20 6:10pm,Bandcamp,album,Music from Saharan Cellphones,Various,USD,7.0,1.0,,7.0,1.4,,,0.57,credit card,8.4,0.0,2038579943,,0.7,0.7,0.0,5.73,82.01,5.73,digital download,,http://sahelsounds.bandcamp.com/album/music-from-saharan-cellphones,,SS-003,889326 667889,,Brandon Simmons,edwardsdaniel@hotmail.com,(740)315-5436x9727,,Sean Martin,77920 Norton Flat Suite 033,,,,,,,,,France,FR,Bas-Rhin,Strasbourg,Recommendations footer: artist recommendation,bandcamp.com/footer/ar/a639873524
642,1/26/20 8:27pm,Bandcamp,album,Music from Saharan WhatsApp,Etran de L'Aïr,USD,6.0,1.0,,6.0,,,,0.35,credit card,6.0,0.0,1519830464,,0.6,0.6,0.0,5.05,87.06,5.05,digital download,,http://etrandelair.bandcamp.com/album/music-from-saharan-whatsapp,,WHATSAPP-01,,,Keith Brown,santosthomas@yahoo.com,(213)200-7810,Thannks from NYC!,Jessica Goodman,37443 Summers Bypass Suite 310,,,,,,,,,United States,US,NY,Brooklyn,Google search,www.google.com/
643,1/26/20 8:58pm,Bandcamp,album,Music from Saharan WhatsApp,Etran de L'Aïr,USD,6.0,1.0,,6.0,,,,0.41,credit card,6.0,0.0,3433882589,,0.6,0.6,0.0,4.99,92.05,4.99,digital download,,http://etrandelair.bandcamp.com/album/music-from-saharan-whatsapp,,WHATSAPP-01,,,April Patrick,aaronbennett@johnston.com,(701)640-7836x72073,,Zachary Waters,414 Ingram Valleys,,,,,,,,,United Kingdom,GB,Edinburgh,Edinburgh,Google search,www.google.com/
644,1/26/20 9:01pm,Bandcamp,album,Music from Saharan WhatsApp,Etran de L'Aïr,USD,5.0,1.0,,5.0,,,,0.35,paypal,5.0,0.0,840350092,,0.5,0.5,0.0,4.15,96.2,4.15,digital download,,http://etrandelair.bandcamp.com/album/music-from-saharan-whatsapp,,WHATSAPP-01,,,Benjamin Ramos,rsantiago@hall-jacobson.com,001-260-673-0062,,Dennis Hensley,9459 Fred Alley,,,,,,,,,United Kingdom,GB,Hertfordshire,Welwyn Garden City,Google search,www.google.com/
645,1/26/20 9:21pm,Bandcamp,package,Sahel Sounds Label Sampler,Various Artists,USD,20.0,1.0,,20.0,,5.0,United States,0.78,paypal,25.0,0.0,400490099,,2.0,2.0,0.0,22.22,118.42,17.22,Sahel Sounds t-shirt,Large,http://sahelsounds.bandcamp.com/merch/sahel-sounds-t-shirt,SS-T01-BLK-ULG,,,,Sabrina Sullivan,buchananwayne@ramirez.org,841.908.8385x959,,Melissa Holden,63421 Collins Forge Apt. 094,,durango,CO,81301,United States,US,1/28/20,,United States,US,CO,durango,,
646,1/27/20 12:05am,Bandcamp,package,Ilana: The Creator,Mdou Moctar,USD,8.0,1.0,,8.0,,4.0,United States,0.53,paypal,12.0,0.0,3069921939,,0.8,0.8,0.0,10.67,129.09,6.67,Ilana: The Creator cassette,,http://mdoumoctar.bandcamp.com/album/ilana-the-creator,SS-028cs,SS-051,602318 136893,,Robert Castro,yjones@hotmail.com,001-814-069-8279x36864,"hey man! your music is transcendent, I appreciate what you do.  I am glad to be alive in the here and now to hear your sounds. I hope to one day experience a live performance.  Thank you for transmitting god's vibrations thru your fingers to my ears.  I hear you! Much respect, Jefe aka Johnny Chiba",Michael Adkins,8335 Lori Hill,,Bronx,NY,10461,United States,US,1/28/20,,United States,US,NY,Bronx,Bandcamp search,bandcamp.com/autocomplete-search
647,1/27/20 12:58am,Bandcamp,album,Sahel Sounds Label Sampler,Various Artists,USD,3.0,1.0,,3.0,,,,0.2,paypal,3.0,0.0,1689673754,,0.3,0.3,0.0,2.5,131.59,2.5,digital download,,http://sahelsounds.bandcamp.com/album/sahel-sounds-label-sampler,,SS-058,602318 137111,,David Cohen,vtaylor@gmail.com,0093653219,,Hailey Johnson,159 Justin Route,,,,,,,,,United States,US,MA,Wellesley Hills,Recommendations footer: artist recommendation,bandcamp.com/footer/ar/a4289860543
648,1/27/20 1:00am,Bandcamp,album,Tenere,Afous d'Afous,USD,7.0,1.0,,7.0,,,,0.57,paypal,7.0,0.0,3246854361,,0.7,0.0,0.7,0.0,131.59,5.73,digital download,,http://afousdafous.bandcamp.com/album/tenere,,SS-042,191515 490421,,David Cohen,craig29@hotmail.com,6388486643,,Zachary Brown,2600 Dalton Loop Apt. 848,,,,,,,,,United States,US,MA,Wellesley Hills,,
649,1/27/20 1:00am,Bandcamp,album,Isswat,Fadimoutou Wallet Inamoud,USD,7.0,1.0,,7.0,,,,,,7.0,0.0,3246854361,,0.7,1.4,0.0,12.03,143.62,6.3,digital download,,http://fadimoutouwalletinamoud.bandcamp.com/album/isswat,,SS-026,889326 667872,,David Cohen,robertsjohn@kidd-schroeder.org,428.451.9360x82715,,Ashley Castillo,472 Sims Brook Suite 550,,,,,,,,,United States,US,MA,Wellesley Hills,,
650,1/27/20 3:42am,Bandcamp,package,Taaritt,Mamman Sani,USD,17.0,1.0,,17.0,,22.0,United States,1.43,paypal,39.0,0.0,2755552582,,1.7,1.7,0.0,35.87,179.49,13.87,Taaritt LP,,http://mammansani.bandcamp.com/album/taaritt,SS-023lp,SS-023,889326 664871,,Joshua Frazier,mary91@padilla.info,+1-743-475-4444x70280,,Jeremy Todd,73168 Katherine Springs Apt. 330,,"2-33-18 Jingumae, Shibuya-ku",Tokyo,1500001,Japan,JP,1/28/20,,Japan,JP,Tokyo,"2-33-18 Jingumae, Shibuya-ku",YouTube: 9dGt1ArYCrI,www.youtube.com/watch?v=9dGt1ArYCrI
651,1/27/20 5:41am,Bandcamp,album,Music from Saharan WhatsApp,Etran de L'Aïr,USD,6.0,1.0,,6.0,,,,0.35,paypal,6.0,0.0,1644262913,,0.6,0.6,0.0,5.05,184.54,5.05,digital download,,http://etrandelair.bandcamp.com/album/music-from-saharan-whatsapp,,WHATSAPP-01,,,Sandra Brown,megan23@yahoo.com,349-175-9396x2024,,Thomas Zhang,2440 Lyons Isle,,,,,,,,,United States,US,CO,Denver,Publish notice sent to your fans,
652,1/27/20 11:23am,Bandcamp,album,Music from Saharan WhatsApp,Etran de L'Aïr,USD,5.0,1.0,,5.0,,,,0.3,credit card,5.0,0.0,2010682727,,0.5,0.5,0.0,4.2,188.74,4.2,digital download,,http://etrandelair.bandcamp.com/album/music-from-saharan-whatsapp,,WHATSAPP-01,,,John Martinez,denise80@gmail.com,+1-593-388-7029x587,,Edwin Cook,533 Dorsey Forges Apt. 804,,,,,,,,,United States,US,NY,The Bronx,,
653,1/27/20 2:14pm,Bandcamp,album,Ilana: The Creator,Mdou Moctar,USD,7.0,1.0,,7.0,1.4,,,0.54,paypal,8.4,0.0,3551665533,,0.7,0.7,0.0,5.76,194.5,5.76,digital download,,http://mdoumoctar.bandcamp.com/album/ilana-the-creator,,SS-051,602318 136893,,Steven Marsh,newmandaniel@smith-thomas.org,278.329.6818x9687,,Michael Burnett,322 Matthew Dam Suite 293,,,,,,,,,United Kingdom,GB,Royal Kensington and Chelsea,Chelsea,Google search,www.google.com/
654,1/27/20 6:02pm,shop@sahelsounds.com,payout,,,USD,,,,,,,,0.2,transfer,20.05,19.85,t254342097,3T962491K0341601G,,,,-20.05,174.45,,,,,,,,,,,,,,,,,,,,,,,,,,,,
655,1/27/20 6:02pm,shop@sahelsounds.com,payout,,,USD,,,,,,,,0.56,transfer,56.23,55.67,t254342101,2NM723385M162683E,,,,-56.23,118.22,,,,,,,,,,,,,,,,,,,,,,,,,,,,
656,1/27/20 7:11pm,Bandcamp,album,Music from Saharan WhatsApp,Etran de L'Aïr,USD,1.0,1.0,,1.0,,,,0.1,paypal,1.0,0.0,921654276,,0.1,0.1,0.0,0.8,119.02,0.8,digital download,,http://etrandelair.bandcamp.com/album/music-from-saharan-whatsapp,,WHATSAPP-01,,,Monica Bennett,anthonyreyes@smith.com,8234254144,,Melanie Gray,588 Gordon Haven,,,,,,,,,United States,US,WI,Rhinelander,Recommendations footer: new and notable,bandcamp.com/footer/nn/a3681570634
657,1/27/20 7:12pm,Bandcamp,album,Music from Saharan WhatsApp,Etran de L'Aïr,USD,3.0,1.0,,3.0,,,,0.2,paypal,3.0,0.0,3950096318,,0.3,0.3,0.0,2.5,121.52,2.5,digital download,,http://etrandelair.bandcamp.com/album/music-from-saharan-whatsapp,,WHATSAPP-01,,,Heather Hayes,obaxter@yahoo.com,(037)250-9606x755,,Theodore Henry,72740 Tamara Park,,,,,,,,,United States,US,MA,Springfield,Bandcamp search,bandcamp.com/app/android/search
658,1/27/20 9:16pm,Bandcamp,album,Sahel Sounds Label Sampler,Various Artists,USD,5.0,1.0,,5.0,,,,0.3,paypal,5.0,0.0,3808050640,,0.5,0.5,0.0,4.2,125.72,4.2,digital download,,http://sahelsounds.bandcamp.com/album/sahel-sounds-label-sampler,,SS-058,602318 137111,,Ryan Williams,lopezjose@lyons-brown.com,(065)627-5072x4934,,Sharon Phillips,29390 Robert Dam Apt. 740,,,,,,,,,United States,US,IL,Waukegan,Google search,www.google.com/
659,1/27/20 9:57pm,Bandcamp,album,Music from Saharan WhatsApp,Etran de L'Aïr,USD,1.0,1.0,,1.0,,,,0.11,credit card,1.0,0.0,2479743869,,0.1,0.1,0.0,0.79,126.51,0.79,digital download,,http://etrandelair.bandcamp.com/album/music-from-saharan-whatsapp,,WHATSAPP-01,,,Abigail King,fernandezrobin@yahoo.com,574.680.8847x6513,,Brian Salazar,99100 Joseph Plaza,,,,,,,,,Spain,ES,Barcelona,Barcelona,Bandcamp search,bandcamp.com/autocomplete-search
660,1/27/20 10:09pm,Bandcamp,album,Music from Saharan WhatsApp,Etran de L'Aïr,USD,1.0,1.0,,1.0,,,,0.11,credit card,1.0,0.0,3429266979,,0.1,0.1,0.0,0.79,127.3,0.79,digital download,,http://etrandelair.bandcamp.com/album/music-from-saharan-whatsapp,,WHATSAPP-01,,,Alan Burgess,brittanybailey@bryant.biz,093.831.2492,,Felicia Campbell,919 Cobb Points Apt. 747,,,,,,,,,United Kingdom,GB,Bristol,Bristol,Bandcamp fan wishlist,bandcamp.com/moomism
661,1/27/20 11:14pm,Bandcamp,album,Music from Saharan WhatsApp,Etran de L'Aïr,USD,10.0,1.0,,10.0,,,,0.52,credit card,10.0,0.0,8718705,,1.0,1.0,0.0,8.48,135.78,8.48,digital download,,http://etrandelair.bandcamp.com/album/music-from-saharan-whatsapp,,WHATSAPP-01,,,Sonya Kelly,tracey03@hansen.org,413-681-7873x0442,,Amber Brown,17225 Hawkins Mountain,,,,,,,,,United States,US,NY,Rochester,Google search,www.google.com/
662,1/27/20 11:31pm,Bandcamp,album,Music from Saharan WhatsApp,Etran de L'Aïr,USD,1.0,1.0,,1.0,,,,0.1,credit card,1.0,0.0,1716909195,,0.1,0.1,0.0,0.8,136.58,0.8,digital download,,http://etrandelair.bandcamp.com/album/music-from-saharan-whatsapp,,WHATSAPP-01,,,Michael Kelley,larry71@anderson-martinez.com,528-410-4883x32190,,Elizabeth Long,905 Angela Spur Suite 898,,,,,,,,,United States,US,MI,Oscoda,Bandcamp music feed: garynorton092 - markvandijk,http://blog.bandcamp.com/2013/09/19/strap-on-your-feed-bag/
663,1/28/20 12:32am,Bandcamp,package,Alghafiat,Amanar De Kidal,USD,7.0,1.0,,7.0,,4.0,United States,0.51,paypal,11.0,0.0,2239948764,,0.7,0.7,0.0,9.79,146.37,5.79,Limited Edition CD,,http://amanardekidal.bandcamp.com/album/alghafiat,ADK-A-LEC,SS-009,889326 664826,,Darren Howard,ryanmckee@hotmail.com,(918)591-0225x197,,David Newton,20529 Ramos Views Apt. 487,,Mount Rainier,MD,20712,United States,US,1/28/20,,United States,US,MD,Mount Rainier,,
664,1/28/20 12:34am,Bandcamp,album,Isswat,Fadimoutou Wallet Inamoud,USD,7.0,1.0,,7.0,,,,0.4,paypal,7.0,0.0,4138212983,,0.7,0.7,0.0,5.9,152.27,5.9,digital download,,http://fadimoutouwalletinamoud.bandcamp.com/album/isswat,,SS-026,889326 667872,,Darren Howard,qhansen@hotmail.com,+1-226-571-4168x866,,Jared Wade,44020 Thomas Mountains Suite 151,,,,,,,,,United States,US,MO,St Louis,sahelsounds.com,sahelsounds.com/artists/amanar/
665,1/28/20 12:43am,Bandcamp,album,Music from Saharan WhatsApp,Etran de L'Aïr,USD,5.0,1.0,,5.0,,,,0.3,paypal,5.0,0.0,2650323067,,0.5,0.5,0.0,4.2,156.47,4.2,digital download,,http://etrandelair.bandcamp.com/album/music-from-saharan-whatsapp,,WHATSAPP-01,,,Dan Schneider,cbowen@ellis.com,+1-755-820-6073x268,,Brittany Taylor,471 Jimenez Stravenue Apt. 002,,,,,,,,,United States,US,MD,Silver Spring,Bandcamp fan wishlist,bandcamp.com/johnfenn3
666,1/28/20 2:29am,Bandcamp,package,Agrim Agadez,Various,USD,15.0,1.0,,15.0,,5.0,United States,0.74,credit card,20.0,0.0,2610407048,,1.5,1.5,0.0,17.76,174.23,12.76,Agrim Agadez LP,,http://sahelsounds.bandcamp.com/album/agrim-agadez,SS-038lp,SS-038,889326 872382,,Daniel Rodriguez,jenniferandrews@yahoo.com,+1-229-485-7147x88006,,Jeremy Moreno,245 Jackson Curve Apt. 117,,North Providence,RI,2911,United States,US,1/28/20,,United States,US,RI,North Providence,Recommendations footer: artist recommendation,bandcamp.com/footer/ar/a2776328381
667,1/28/20 2:54am,Bandcamp,album,Music from Saharan WhatsApp,Etran de L'Aïr,USD,1.0,1.0,,1.0,,,,0.1,paypal,1.0,0.0,1739415257,,0.1,0.1,0.0,0.8,175.03,0.8,digital download,,http://etrandelair.bandcamp.com/album/music-from-saharan-whatsapp,,WHATSAPP-01,,,Barbara Young,larry36@yahoo.com,+1-601-560-9574x77039,,Alexandria Hensley,18480 Jackson Path Apt. 480,,,,,,,,,United States,US,IL,Lake Zurich,Bandcamp search,bandcamp.com/autocomplete-search
668,1/28/20 6:16am,Bandcamp,album,Music from Saharan WhatsApp,Etran de L'Aïr,USD,4.0,1.0,,4.0,,,,0.25,paypal,4.0,0.0,4187564662,,0.4,0.4,0.0,3.35,178.38,3.35,digital download,,http://etrandelair.bandcamp.com/album/music-from-saharan-whatsapp,,WHATSAPP-01,,,Kenneth Smith,jon22@gmail.com,+1-486-187-9266x693,,Felicia Welch,63326 Barbara Stream,,,,,,,,,United States,US,MO,St Louis,,
669,1/28/20 6:18am,Bandcamp,album,Music from Saharan Cellphones,Various,USD,10.0,1.0,,10.0,,,,0.49,paypal,10.0,0.0,3653620352,,1.0,1.0,0.0,8.51,186.89,8.51,digital download,,http://sahelsounds.bandcamp.com/album/music-from-saharan-cellphones,,SS-003,889326 667889,,Robert White,osteele@hotmail.com,(555)273-0874,,Scott Thomas,443 Lee Ports,,,,,,,,,United States,US,IN,Munster,tumblr.com,www.tumblr.com/
670,1/28/20 6:24am,Bandcamp,album,Eghass Malan,Les Filles de Illighadad,USD,7.0,1.0,,7.0,,,,0.4,paypal,7.0,0.0,2545067639,,0.7,0.7,0.0,5.9,192.79,5.9,digital download,,http://lesfillesdeillighadad.bandcamp.com/album/eghass-malan,,SS-044,191515 928351,,Rebecca Miller,xyoung@gmail.com,(555)123-2341x13882,,Donald Fields,35397 Chad Square Suite 963,,,,,,,,,United States,US,CA,Berkeley,Bandcamp search,bandcamp.com/app/android/search
671,1/28/20 8:18am,Bandcamp,album,Music from Saharan WhatsApp,Etran de L'Aïr,USD,6.0,1.0,,6.0,,,,0.41,paypal,6.0,0.0,162355868,,0.6,0.6,0.0,4.99,197.78,4.99,digital download,,http://etrandelair.bandcamp.com/album/music-from-saharan-whatsapp,,WHATSAPP-01,,,Debra Burns,bwarner@hotmail.com,001-577-979-7864x7486,,Troy Whitaker,0987 Shawn Way,,,,,,,,,United Kingdom,GB,,,Google search,www.google.co.uk/
672,1/28/20 8:40am,Bandcamp,album,Music from Saharan WhatsApp,Etran de L'Aïr,USD,3.0,1.0,,3.0,,,,0.11,credit card,3.0,0.0,3045470889,,0.3,0.3,0.0,2.59,200.37,2.59,digital download,,http://etrandelair.bandcamp.com/album/music-from-saharan-whatsapp,,WHATSAPP-01,,,Justin Clay,lyoder@yahoo.com,+1-555-564-3311,,Lisa Gibson,552 Joshua Isle Apt. 286,,,,,,,,,United States,US,OR,Portland,Google search,www.google.com/
673,1/28/20 12:37pm,Bandcamp,album,Music from Saharan WhatsApp,Etran de L'Aïr,USD,4.0,1.0,,4.0,,,,0.29,paypal,4.0,0.0,3490259135,,0.4,0.4,0.0,3.31,203.68,3.31,digital download,,http://etrandelair.bandcamp.com/album/music-from-saharan-whatsapp,,WHATSAPP-01,,,Kathryn Evans,schmidtlinda@duncan-goodman.com,(779)387-7208x2579,,Lisa Flynn,1446 Wilson Center,,,,,,,,,France,FR,Puy-de-Dôme,Clermont-Ferrand,,
674,1/28/20 1:02pm,Bandcamp,album,Les Filles de Illighadad,Les Filles de Illighadad,USD,7.0,1.0,,7.0,1.33,,,0.54,paypal,8.33,0.0,4209708075,,0.7,0.7,0.0,5.76,209.44,5.76,digital download,,http://lesfillesdeillighadad.bandcamp.com/album/les-filles-de-illighadad,,SS-033,889326 664918,,Mark Page,karencoleman@yahoo.com,486.499.6609,,Samantha Patel,66841 Christine Lake,,,,,,,,,Germany,DE,North Rhine-Westphalia,Cologne,Google search,www.google.com/
675,1/28/20 1:02pm,Bandcamp,album,Sahel Sounds Label Sampler,Various Artists,USD,1.0,1.0,,1.0,,,,0.11,paypal,1.0,0.0,559050058,,0.1,0.1,0.0,0.79,210.23,0.79,digital download,,http://sahelsounds.bandcamp.com/album/sahel-sounds-label-sampler,,SS-058,602318 137111,,Mark Page,phillipsanna@franklin-mcgee.biz,030.912.2391x565,,Walter Baker,4842 Frank Hill Suite 538,,,,,,,,,Germany,DE,North Rhine-Westphalia,Cologne,bandcamp.com,bandcamp.com
676,1/28/20 3:18pm,Bandcamp,album,Music from Saharan WhatsApp,Etran de L'Aïr,USD,1.0,1.0,,1.0,,,,0.1,credit card,1.0,0.0,1100841913,,0.1,0.1,0.0,0.8,211.03,0.8,digital download,,http://etrandelair.bandcamp.com/album/music-from-saharan-whatsapp,,WHATSAPP-01,,,Vanessa Scott,hernandezmanuel@miller-ramsey.info,(189)287-0792,,Joshua Barnes,28073 Smith Fort Suite 458,,,,,,,,,United States,US,TX,Austin,sahelsounds.com,sahelsounds.com/
677,1/28/20 4:49pm,Bandcamp,album,Music from Saharan WhatsApp,Etran de L'Aïr,USD,10.0,1.0,,10.0,,,,0.52,credit card,10.0,0.0,4041216894,,1.0,1.0,0.0,8.48,219.51,8.48,digital download,,http://etrandelair.bandcamp.com/album/music-from-saharan-whatsapp,,WHATSAPP-01,,,Brandon Short,scott26@yahoo.com,766.734.0326x09877,,Lisa Dunlap,2976 Kelly Trace Suite 490,,,,,,,,,United States,US,NC,Charlotte,,
678,1/28/20 5:45pm,Bandcamp,album,Music from Saharan WhatsApp,Etran de L'Aïr,USD,3.0,1.0,,3.0,,,,0.2,credit card,3.0,0.0,2684937080,,0.3,0.3,0.0,2.5,222.01,2.5,digital download,,http://etrandelair.bandcamp.com/album/music-from-saharan-whatsapp,,WHATSAPP-01,,,Travis Gordon,amanda46@glover.net,673-006-0589x6691,,Melissa Davies,39022 Mills Circles Apt. 625,,,,,,,,,United States,US,CA,Santa Monica,Bandcamp search,bandcamp.com/autocomplete-search
679,1/28/20 6:02pm,shop@sahelsounds.com,payout,,,USD,,,,,,,,0.92,transfer,92.28,91.36,t254563929,9VT54532DC611463G,,,,-92.28,129.73,,,,,,,,,,,,,,,,,,,,,,,,,,,,
680,1/28/20 6:02pm,shop@sahelsounds.com,payout,,,USD,,,,,,,,0.26,transfer,25.94,25.68,t254563926,3TB36864L9086110H,,,,-25.94,103.79,,,,,,,,,,,,,,,,,,,,,,,,,,,,
681,1/28/20 6:28pm,Bandcamp,refund,Sahel Sounds Label Sampler,Various Artists,USD,20.0,-1.0,,-20.0,,-5.0,United States,-0.85,credit card,-25.0,,t254569515,,-2.0,-2.0,0.0,-22.15,81.64,,Sahel Sounds t-shirt,Large,http://sahelsounds.bandcamp.com/merch/sahel-sounds-t-shirt,SS-T01-BLK-ULG,,,,Tyler Willis,eoliver@adams.com,001-237-034-3899x84156,,Courtney Perez,9867 Robert Extensions Apt. 000,9 Lomas dr.,durango,CO,81301,United States,US,,,United States,US,CO,durango,Google search,www.google.com/
682,1/28/20 7:36pm,Bandcamp,album,Music from Saharan WhatsApp,Etran de L'Aïr,USD,3.0,1.0,,3.0,,,,0.23,paypal,3.0,0.0,361078855,,0.3,0.3,0.0,2.47,84.11,2.47,digital download,,http://etrandelair.bandcamp.com/album/music-from-saharan-whatsapp,,WHATSAPP-01,,,Laura Flynn,sarah56@snyder-porter.com,121.868.5370x614,,Robin Romero,9147 Nelson Meadows Apt. 292,,,,,,,,,Spain,ES,Barcelona,Barcelona,Bandcamp search,bandcamp.com/app/android/search
683,1/28/20 8:43pm,Bandcamp,album,Ilana: The Creator,Mdou Moctar,USD,7.0,1.0,,7.0,,,,0.57,paypal,7.0,0.0,407036852,,0.7,0.0,0.7,0.0,84.11,5.73,digital download,,http://mdoumoctar.bandcamp.com/album/ilana-the-creator,,SS-051,602318 136893,,Julie Howell,timothymoreno@pierce.com,9427125174,,Latasha Tate,3583 Brenda Ferry Apt. 007,,,,,,,,,United States,US,WA,,Recommendations footer: album of the day,bandcamp.com/footer/aotd/a3521313782
684,1/28/20 8:43pm,Bandcamp,album,Akounak Tedalat Taha Tazoughai OST,Mdou Moctar,USD,7.0,1.0,,7.0,,,,,,7.0,0.0,407036852,,0.7,1.4,0.0,12.03,96.14,6.3,digital download,,http://mdoumoctar.bandcamp.com/album/akounak-tedalat-taha-tazoughai-ost,,SS-028,889326 667599,,Julie Howell,collinselizabeth@gmail.com,001-019-179-6030x86958,,Douglas Jones,19029 Michelle Corners,,,,,,,,,United States,US,WA,,Recommendations footer: album of the day,bandcamp.com/footer/aotd/a3521313782
685,1/28/20 9:08pm,Bandcamp,package,Balani Show Super Hits: Electronic Street Parties from Mali,Various,USD,17.0,1.0,,17.0,,5.0,United States,0.78,credit card,22.0,0.0,1727189174,,1.7,1.7,0.0,19.52,115.66,14.52,Balani LP,,http://sahelsounds.bandcamp.com/album/balani-show-super-hits-electronic-street-parties-from-mali,SS-BSSH-BL,SS-021,889326 667643,,James Pitts,greenrichard@hotmail.com,(353)726-8380x4492,,Maria Martin,1597 Porter Mill,,San diego,CA,92101,United States,US,2/11/20,,United States,US,CA,San diego,Publish notice sent to your fans,
686,1/28/20 9:09pm,Bandcamp,package,Balani Show Super Hits: Electronic Street Parties from Mali,Various,USD,18.0,1.0,,18.0,,5.0,United States,0.74,paypal,23.0,0.0,3788460963,,1.8,1.8,0.0,20.46,136.12,15.46,Balani LP,,http://sahelsounds.bandcamp.com/album/balani-show-super-hits-electronic-street-parties-from-mali,SS-BSSH-BL,SS-021,889326 667643,,Meghan Vargas,christopher98@kirk.com,+1-861-219-1919x4327,,Lauren Cooper,593 Susan Terrace,,Cayey,PR,737,United States,US,2/11/20,,United States,US,PR,Cayey,Publish notice sent to your fans,
687,1/28/20 9:16pm,Bandcamp,album,Balani Show Super Hits: Electronic Street Parties from Mali,Various,USD,7.0,1.0,,7.0,,,,0.4,paypal,7.0,0.0,521328114,,0.7,0.7,0.0,5.9,142.02,5.9,digital download,,http://sahelsounds.bandcamp.com/album/balani-show-super-hits-electronic-street-parties-from-mali,,SS-021,889326 667643,,Chelsey Williams,mark49@rodriguez.com,+1-992-951-3509,,Melissa Mejia,647 Gregory Streets Apt. 223,,,,,,,,,United States,US,NY,Rochester,Publish notice sent to your fans,
688,1/28/20 9:23pm,Bandcamp,album,Music from Saharan WhatsApp,Etran de L'Aïr,USD,3.0,1.0,,3.0,,,,0.2,paypal,3.0,0.0,1301810330,,0.3,0.3,0.0,2.5,144.52,2.5,digital download,,http://etrandelair.bandcamp.com/album/music-from-saharan-whatsapp,,WHATSAPP-01,,,Gregory Day,donna16@gmail.com,315.066.9888,,Jared Moran,81544 Jonathan Mount,,,,,,,,,United States,US,MN,Minneapolis,Publish notice sent to your fans,
689,1/28/20 9:26pm,Bandcamp,album,Falaw,Luka Productions,USD,7.0,1.0,,7.0,1.47,,,0.55,paypal,8.47,0.0,3523773242,,0.7,0.7,0.0,5.75,150.27,5.75,digital download,,http://lukaproductions.bandcamp.com/album/falaw,,SS-052,602318 136855,,Julie Garcia,anthony46@fitzpatrick.com,4566386625,,Robert Burke,000 Julia Stream,,,,,,,,,Netherlands,NL,North Holland,Amsterdam,Publish notice sent to your fans,
690,1/28/20 9:32pm,Bandcamp,album,Music from Saharan WhatsApp,Etran de L'Aïr,USD,1.0,1.0,,1.0,,,,0.1,paypal,1.0,0.0,4111870001,,0.1,0.1,0.0,0.8,151.07,0.8,digital download,,http://etrandelair.bandcamp.com/album/music-from-saharan-whatsapp,,WHATSAPP-01,,,Peter Nichols,walkerann@holden.com,001-682-339-4206x003,,Lauren Chang,70560 Melissa Crest,,,,,,,,,United States,US,NJ,Bordentown,,
691,1/28/20 9:48pm,Bandcamp,package,Balani Show Super Hits: Electronic Street Parties from Mali,Various,USD,17.0,1.0,,17.0,,5.0,United States,0.78,credit card,22.0,0.0,3597330722,,1.7,1.7,0.0,19.52,170.59,14.52,Balani LP,,http://sahelsounds.bandcamp.com/album/balani-show-super-hits-electronic-street-parties-from-mali,SS-BSSH-BL,SS-021,889326 667643,,Andrew Brown,richardpoole@thompson.biz,(519)535-7226x5229,,Rebecca Miller,1472 Haynes Shore,,Altadena,CA,91001-1702,United States,US,2/11/20,,United States,US,CA,Altadena,Publish notice sent to your fans,
692,1/28/20 9:50pm,Bandcamp,album,Balani Show Super Hits: Electronic Street Parties from Mali,Various,USD,7.0,1.0,,7.0,,,,0.47,paypal,7.0,0.0,704779067,,0.7,0.7,0.0,5.83,176.42,5.83,digital download,,http://sahelsounds.bandcamp.com/album/balani-show-super-hits-electronic-street-parties-from-mali,,SS-021,889326 667643,,Nicole Rodriguez,hgoodman@ray-morse.com,3718378039,,Angela Cook,0690 Joshua Forge Suite 225,,,,,,,,,Guernsey,GG,,St Peter Port,Publish notice sent to your fans,
693,1/28/20 9:59pm,Bandcamp,package,Balani Show Super Hits: Electronic Street Parties from Mali,Various,USD,17.0,1.0,,17.0,,20.0,United States,1.48,credit card,37.0,0.0,3941393369,,1.7,1.7,0.0,33.82,210.24,13.82,Balani LP,,http://sahelsounds.bandcamp.com/album/balani-show-super-hits-electronic-street-parties-from-mali,SS-BSSH-BL,SS-021,889326 667643,,Suzanne Vasquez,meganrussell@vargas-chapman.com,980-535-5863x72961,,Holly Grant,1563 Garcia Mill,,VOUHÉ,,79310,France,FR,2/11/20,,France,FR,,VOUHÉ,Publish notice sent to your fans,
694,1/28/20 10:22pm,Bandcamp,album,Balani Show Super Hits: Electronic Street Parties from Mali,Various,USD,8.0,1.0,,8.0,,,,0.45,paypal,8.0,0.0,1624257908,,0.8,0.8,0.0,6.75,216.99,6.75,digital download,,http://sahelsounds.bandcamp.com/album/balani-show-super-hits-electronic-street-parties-from-mali,,SS-021,889326 667643,,Aaron Ortega,perrymary@wyatt.org,974.337.2475x8604,,Jacob Wright,46762 Haley Canyon,,,,,,,,,United States,US,,,,
695,1/28/20 10:34pm,Bandcamp,album,Music from Saharan WhatsApp,Etran de L'Aïr,USD,1.0,1.0,,1.0,,,,0.11,paypal,1.0,0.0,4230839025,,0.1,0.1,0.0,0.79,217.78,0.79,digital download,,http://etrandelair.bandcamp.com/album/music-from-saharan-whatsapp,,WHATSAPP-01,,,Julie Quinn,nclark@morales.com,290.674.6818x28354,,Maureen Morrison,115 Terrance Union,,,,,,,,,Netherlands,NL,South Holland,Dordrecht,Bandcamp search,bandcamp.com/autocomplete-search
696,1/28/20 11:30pm,Bandcamp,album,Eghass Malan,Les Filles de Illighadad,USD,7.0,1.0,,7.0,,,,0.47,paypal,7.0,0.0,1488155600,,0.7,0.7,0.0,5.83,223.61,5.83,digital download,,http://lesfillesdeillighadad.bandcamp.com/album/eghass-malan,,SS-044,191515 928351,,Nicholas Murphy,jerryvasquez@hotmail.com,4160441396,,Jeffrey Harrison,67874 Lambert Locks Suite 679,,,,,,,,,Canada,CA,BC,Vancouver,Bandcamp search: “les filles de illighadad”,bandcamp.com/search?q=Les%20Filles%20de%20Illighadad
697,1/29/20 12:24am,Bandcamp,album,Balani Show Super Hits: Electronic Street Parties from Mali,Various,USD,8.0,1.0,,8.0,,,,0.45,paypal,8.0,0.0,1792383925,,0.8,0.8,0.0,6.75,230.36,6.75,digital download,,http://sahelsounds.bandcamp.com/album/balani-show-super-hits-electronic-street-parties-from-mali,,SS-021,889326 667643,,Candace Tate,brandon05@webster.biz,416.361.7481x225,,Carol Graves,930 Hall Trace Suite 728,,,,,,,,,United States,US,NJ,West Orange,Publish notice sent to your fans,
698,1/29/20 1:01am,Bandcamp,album,Balani Show Super Hits: Electronic Street Parties from Mali,Various,USD,7.0,1.0,,7.0,1.33,,,0.55,paypal,8.33,0.0,586273452,,0.7,0.7,0.0,5.75,236.11,5.75,digital download,,http://sahelsounds.bandcamp.com/album/balani-show-super-hits-electronic-street-parties-from-mali,,SS-021,889326 667643,,Jessica Carpenter,khanlinda@hotmail.com,001-369-505-9455x896,,Brady Warren,93210 Casey Mill,,,,,,,,,Germany,DE,Land Berlin,Berlin,,
699,1/29/20 1:11am,Bandcamp,album,Eghass Malan,Les Filles de Illighadad,USD,7.0,1.0,,7.0,,,,0.4,credit card,7.0,0.0,4084864689,,0.7,0.7,0.0,5.9,242.01,5.9,digital download,,http://lesfillesdeillighadad.bandcamp.com/album/eghass-malan,,SS-044,191515 928351,,Lawrence Davis,thomas86@rodriguez-rosales.com,001-419-608-0922,,Stephen Martinez,49202 Reeves Shoal Suite 348,,,,,,,,,United States,US,CA,Oakland,duckduckgo.com,duckduckgo.com/
700,1/29/20 1:43am,Bandcamp,album,La Musique Electronique du Niger,Mamman Sani,USD,7.0,1.0,,7.0,,,,0.4,paypal,7.0,0.0,1926833136,,0.7,0.7,0.0,5.9,247.91,5.9,digital download,,http://mammansani.bandcamp.com/album/la-musique-electronique-du-niger,,SS-011,889326 664864,,Denise Torres,alyssavalentine@gmail.com,305-932-9772x20460,,Caitlin Alexander,64718 Cunningham Expressway,,,,,,,,,United States,US,WA,Bellevue,Recommendations footer: artist recommendation,bandcamp.com/footer/ar/a2776328381
701,1/29/20 2:13am,Bandcamp,album,Balani Show Super Hits: Electronic Street Parties from Mali,Various,USD,10.0,1.0,,10.0,,,,0.49,paypal,10.0,0.0,3826046276,,1.0,1.0,0.0,8.51,256.42,8.51,digital download,,http://sahelsounds.bandcamp.com/album/balani-show-super-hits-electronic-street-parties-from-mali,,SS-021,889326 667643,,Norma Freeman,teresaerickson@gonzalez.net,+1-645-208-9709x15820,,Amber Day,171 Jason Bridge,,,,,,,,,United States,US,CA,Oakland,Publish notice sent to your fans,
702,1/29/20 2:48am,Bandcamp,package,Balani Show Super Hits: Electronic Street Parties from Mali,Various,USD,17.0,1.0,,17.0,,5.0,United States,0.72,paypal,22.0,0.0,3111156597,,1.7,1.7,0.0,19.58,276.0,14.58,Balani LP,,http://sahelsounds.bandcamp.com/album/balani-show-super-hits-electronic-street-parties-from-mali,SS-BSSH-BL,SS-021,889326 667643,,David Warren,deleonlarry@young.com,(074)372-4183x99139,,George Valdez,9386 Anna Square,Apt. 103,Los Angeles,CA,90034,United States,US,2/11/20,,United States,US,CA,Los Angeles,Publish notice sent to your fans,
703,1/29/20 2:52am,Bandcamp,album,Ilana: The Creator,Mdou Moctar,USD,10.0,1.0,,10.0,,,,0.49,paypal,10.0,0.0,1552415817,,1.0,1.0,0.0,8.51,284.51,8.51,digital download,,http://mdoumoctar.bandcamp.com/album/ilana-the-creator,,SS-051,602318 136893,,Misty Wilson,riverakeith@yahoo.com,777.681.2392x4888,,Jessica Cole,2560 Justin Meadow,,,,,,,,,United States,US,NY,The Bronx,Bandcamp search: “mdou moctar”,bandcamp.com/search?q=Mdou%20Moctar
704,1/29/20 3:51am,Bandcamp,album,Music from Saharan WhatsApp,Etran de L'Aïr,USD,3.0,1.0,,3.0,,,,0.2,paypal,3.0,0.0,690968275,,0.3,0.3,0.0,2.5,287.01,2.5,digital download,,http://etrandelair.bandcamp.com/album/music-from-saharan-whatsapp,,WHATSAPP-01,,,James Jackson,danielsmichael@yahoo.com,+1-237-232-8886x722,,Ryan Jackson,167 Cardenas Meadows,,,,,,,,,United States,US,NY,New York,sahelsounds.com,sahelsounds.com/
705,1/29/20 3:51am,Bandcamp,album,Music from Saharan WhatsApp,Etran de L'Aïr,USD,3.0,1.0,,3.0,,,,0.2,credit card,3.0,0.0,2539005596,,0.3,0.3,0.0,2.5,289.51,2.5,digital download,,http://etrandelair.bandcamp.com/album/music-from-saharan-whatsapp,,WHATSAPP-01,,,William Jones,wayne75@george.com,(071)999-3475x905,,Darrell Wang,54044 Donna Mount,,,,,,,,,United States,US,TX,Austin,Bandcamp search: “music from saharan whatsapp”,bandcamp.com/search?q=music%20from%20saharan%20whatsapp
706,1/29/20 4:04am,Bandcamp,album,Anou Malane,Abdallah Ag Oumbadougou,USD,7.0,1.0,,7.0,,,,0.47,paypal,7.0,0.0,707802416,,0.7,0.7,0.0,5.83,295.34,5.83,digital download,,http://abdallahagoumbadougou.bandcamp.com/album/anou-malane,,SS-053,602318 136992,,Jonathan Moore,zwhite@yahoo.com,324-347-8723x934,,James Vega,16504 Matthews Via,,,,,,,,,Canada,CA,BC,Kamloops,Publish notice sent to your fans,
707,1/29/20 4:05am,Bandcamp,album,Music from Saharan WhatsApp,Etran de L'Aïr,USD,5.0,1.0,,5.0,,,,0.35,credit card,5.0,0.0,1908726736,,0.5,0.5,0.0,4.15,299.49,4.15,digital download,,http://etrandelair.bandcamp.com/album/music-from-saharan-whatsapp,,WHATSAPP-01,,,Michelle Russell,rodriguezwilliam@johnson-harris.biz,(050)892-0193x0283,,Philip Cannon,68757 Douglas Mission,,,,,,,,,Canada,CA,ON,Toronto,Bandcamp fan wishlist,bandcamp.com/rotundcivet
708,1/29/20 7:51am,Bandcamp,album,Eghass Malan,Les Filles de Illighadad,USD,7.0,1.0,,7.0,,,,0.4,paypal,7.0,0.0,3797915812,,0.7,0.7,0.0,5.9,305.39,5.9,digital download,,http://lesfillesdeillighadad.bandcamp.com/album/eghass-malan,,SS-044,191515 928351,,Michelle Lane,opace@hotmail.com,702-320-3203x25680,,Danielle Williams,318 Jorge Stream Suite 319,,,,,,,,,United States,US,NY,New York,,
709,1/29/20 8:48am,Bandcamp,album,Music from Saharan WhatsApp,Etran de L'Aïr,USD,1.0,1.0,,1.0,,,,0.1,paypal,1.0,0.0,3696649674,,0.1,0.1,0.0,0.8,306.19,0.8,digital download,,http://etrandelair.bandcamp.com/album/music-from-saharan-whatsapp,,WHATSAPP-01,,,Yvonne Ferguson,grahammarissa@gmail.com,711-217-9244x9788,,Rhonda Grant,3707 Salas Ranch,,,,,,,,,India,IN,Bihar,Patna,Google search,www.google.com/
710,1/29/20 9:55am,Bandcamp,album,La Musique Electronique du Niger,Mamman Sani,USD,7.0,1.0,,7.0,1.4,,,0.57,credit card,8.4,0.0,203608199,,0.7,0.7,0.0,5.73,311.92,5.73,digital download,,http://mammansani.bandcamp.com/album/la-musique-electronique-du-niger,,SS-011,889326 664864,,Elizabeth Gordon,qdavis@schroeder.net,+1-104-716-4674x58947,,Andrea Mercer,83490 Bradley Points Suite 461,,,,,,,,,France,FR,Paris,Paris,Publish notice sent to your fans,
711,1/29/20 10:19am,Bandcamp,package,Balani Show Super Hits: Electronic Street Parties from Mali,Various,USD,17.0,1.0,,17.0,,5.0,United States,0.72,paypal,22.0,0.0,3598783107,,1.7,1.7,0.0,19.58,331.5,14.58,Balani LP,,http://sahelsounds.bandcamp.com/album/balani-show-super-hits-electronic-street-parties-from-mali,SS-BSSH-BL,SS-021,889326 667643,,Donald Rowe,psmith@yahoo.com,470-155-8250,,Brittany Williamson,8862 Kathleen Knolls,3A,Ridgewood,NY,11385,United States,US,2/11/20,,United States,US,NY,Ridgewood,Publish notice sent to your fans,
712,1/29/20 12:05pm,Bandcamp,album,Music from Saharan WhatsApp,Etran de L'Aïr,USD,3.0,1.0,,3.0,,,,0.23,paypal,3.0,0.0,1196857167,,0.3,0.3,0.0,2.47,333.97,2.47,digital download,,http://etrandelair.bandcamp.com/album/music-from-saharan-whatsapp,,WHATSAPP-01,,,Brian Pratt,willisjennifer@ramirez-daniel.com,5555027693,,Rhonda Johnson,364 Christopher Row,,,,,,,,,United Kingdom,GB,Glasgow City,Glasgow,Bandcamp fan page: drammel,bandcamp.com/drammel
713,1/29/20 12:35pm,Bandcamp,album,Music from Saharan WhatsApp,Etran de L'Aïr,USD,10.0,1.0,,10.0,,,,0.59,paypal,10.0,0.0,283252867,,1.0,1.0,0.0,8.41,342.38,8.41,digital download,,http://etrandelair.bandcamp.com/album/music-from-saharan-whatsapp,,WHATSAPP-01,,,Patrick Campbell,courtneycollier@miller.com,583-482-5702x308,,Elizabeth Edwards,48173 Kristen Station Apt. 151,,,,,,,,,Australia,AU,QLD,Brisbane,Bandcamp search,bandcamp.com/autocomplete-search
714,1/29/20 3:47pm,Bandcamp,album,Music from Saharan WhatsApp,Etran de L'Aïr,USD,5.0,1.0,,5.0,,,,0.3,paypal,5.0,0.0,1559272635,,0.5,0.5,0.0,4.2,346.58,4.2,digital download,,http://etrandelair.bandcamp.com/album/music-from-saharan-whatsapp,,WHATSAPP-01,,,Michael Howard,johnhernandez@gmail.com,001-050-143-0735x2372,,Joshua Johnson,05546 Newman Forges,,,,,,,,,United States,US,MN,Winona,Bandcamp artist: etrandelair,etrandelair.bandcamp.com/album/music-from-saharan-whatsapp
715,1/29/20 3:53pm,Bandcamp,album,Ilana: The Creator,Mdou Moctar,USD,7.0,1.0,,7.0,,,,0.4,credit card,7.0,0.0,1239606638,,0.7,0.7,0.0,5.9,352.48,5.9,digital download,,http://mdoumoctar.bandcamp.com/album/ilana-the-creator,,SS-051,602318 136893,,Richard Pacheco,knelson@pineda.com,+1-890-774-8652x85296,,Sheri Young,922 Glen Rest Apt. 094,,,,,,,,,United States,US,CA,Pasadena,Bandcamp search,bandcamp.com/autocomplete-search
716,1/29/20 3:59pm,Bandcamp,album,Music from Saharan WhatsApp,Etran de L'Aïr,USD,1.0,1.0,,1.0,,,,0.11,paypal,1.0,0.0,889633576,,0.1,0.1,0.0,0.79,353.27,0.79,digital download,,http://etrandelair.bandcamp.com/album/music-from-saharan-whatsapp,,WHATSAPP-01,,,Kathryn Morgan,hortonaustin@moore-salazar.com,+1-758-112-3164x2510,,Mia Rogers,98886 Garcia Ferry,,,,,,,,,United Kingdom,GB,Bradford,Bradford,Google search,www.google.com/
717,1/29/20 4:10pm,Bandcamp,album,Anou Malane,Abdallah Ag Oumbadougou,USD,10.0,1.0,,10.0,,,,0.49,paypal,10.0,0.0,3414165210,,1.0,1.0,0.0,8.51,361.78,8.51,digital download,,http://abdallahagoumbadougou.bandcamp.com/album/anou-malane,,SS-053,602318 136992,,Michael Rodriguez,herreraronald@briggs.com,622.131.9207x6683,,Wanda Garcia,164 Anderson Village,,,,,,,,,United States,US,TX,Houston,Bandcamp search,bandcamp.com/autocomplete-search
718,1/29/20 4:12pm,Bandcamp,package,Sahel Sounds Label Sampler,Various Artists,USD,30.0,1.0,,30.0,,5.0,United States,0.97,paypal,35.0,0.0,493887506,,3.0,3.0,0.0,31.03,392.81,26.03,Sahel Sounds t-shirt,Large,http://sahelsounds.bandcamp.com/merch/sahel-sounds-t-shirt,SS-T01-BLK-ULG,,,,Michael Rodriguez,morganwagner@walton.info,073-331-1622x073,,Mary Aguilar,1299 Soto Row Apt. 147,,SAN JOSE,CA,95125,United States,US,2/4/20,,United States,US,CA,SAN JOSE,Bandcamp search: “sahel sounds”,bandcamp.com/search?q=sahel%20sounds
719,1/29/20 4:47pm,Bandcamp,album,La Musique Electronique du Niger,Mamman Sani,USD,7.0,1.0,,7.0,,,,0.4,credit card,7.0,0.0,2393944585,,0.7,0.7,0.0,5.9,398.71,5.9,digital download,,http://mammansani.bandcamp.com/album/la-musique-electronique-du-niger,,SS-011,889326 664864,,Frances Santana,taylorkatrina@barrett.com,+1-865-765-5720x92521,,Thomas Mendoza,41536 Parsons Heights Suite 881,,,,,,,,,United States,US,VA,Charlottesville,Google search,www.google.com/
720,1/29/20 4:59pm,Bandcamp,album,Music from Saharan WhatsApp,Etran de L'Aïr,USD,3.0,1.0,,3.0,,,,0.2,paypal,3.0,0.0,3752500453,,0.3,0.3,0.0,2.5,401.21,2.5,digital download,,http://etrandelair.bandcamp.com/album/music-from-saharan-whatsapp,,WHATSAPP-01,,,David Newman,jenniferrobinson@vaughan.net,001-813-832-7912x011,,Desiree Davis,364 Joshua Canyon Suite 280,,,,,,,,,United States,US,PA,Philadelphia,Bandcamp music feed,http://blog.bandcamp.com/2013/09/19/strap-on-your-feed-bag/
721,1/29/20 5:12pm,Bandcamp,album,Music from Saharan WhatsApp,Etran de L'Aïr,USD,1.0,1.0,,1.0,,,,0.11,paypal,1.0,0.0,3432931973,,0.1,0.1,0.0,0.79,402.0,0.79,digital download,,http://etrandelair.bandcamp.com/album/music-from-saharan-whatsapp,,WHATSAPP-01,,,Dylan Kim,wilsonanita@yahoo.com,(394)904-1525x159,,Mary Hill,7321 Tiffany Fall,,,,,,,,,United Kingdom,GB,Sheffield,Sheffield,Bandcamp music feed,http://blog.bandcamp.com/2013/09/19/strap-on-your-feed-bag/
722,1/29/20 6:02pm,shop@sahelsounds.com,payout,,,USD,,,,,,,,0.45,transfer,45.01,44.56,t254783478,28A72957UJ450262T,,,,-45.01,356.99,,,,,,,,,,,,,,,,,,,,,,,,,,,,
723,1/29/20 6:02pm,shop@sahelsounds.com,payout,,,USD,,,,,,,,0.37,transfer,36.63,36.26,t254783475,4EC038780A9382207,,,,-36.63,320.36,,,,,,,,,,,,,,,,,,,,,,,,,,,,
724,1/29/20 6:27pm,Bandcamp,album,Music from Saharan WhatsApp,Etran de L'Aïr,USD,5.0,1.0,,5.0,,,,0.3,credit card,5.0,0.0,93571798,,0.5,0.5,0.0,4.2,324.56,4.2,digital download,,http://etrandelair.bandcamp.com/album/music-from-saharan-whatsapp,,WHATSAPP-01,,,Steven Gaines,zdunlap@lee.com,001-452-166-4983x62020,,Jason Boyer,8817 Warren Squares Apt. 029,,,,,,,,,United States,US,IL,Skokie,Google search,www.google.com/
725,1/29/20 8:09pm,Bandcamp,album,Anou Malane,Abdallah Ag Oumbadougou,USD,7.0,1.0,,7.0,,,,0.4,paypal,7.0,0.0,780872893,,0.7,0.7,0.0,5.9,330.46,5.9,digital download,,http://abdallahagoumbadougou.bandcamp.com/album/anou-malane,,SS-053,602318 136992,,Abigail Farrell,petersencorey@simon.org,001-607-563-0921x06439,,Nicholas Thompson,925 Andrew Road,,,,,,,,,United States,US,NC,Charlotte,Publish notice sent to your fans,
726,1/29/20 10:05pm,Bandcamp,album,Music from Saharan WhatsApp,Etran de L'Aïr,USD,3.0,1.0,,3.0,,,,0.23,credit card,3.0,0.0,1891326235,,0.3,0.3,0.0,2.47,332.93,2.47,digital download,,http://etrandelair.bandcamp.com/album/music-from-saharan-whatsapp,,WHATSAPP-01,,,Michael Moody,bbrown@cooper.com,001-567-680-8895x8483,,Kayla Elliott,81584 Yvonne Loaf,,,,,,,,,United Kingdom,GB,City of Westminster,Paddington,Google search,www.google.com/
727,1/29/20 10:45pm,Bandcamp,album,Ilana: The Creator,Mdou Moctar,USD,7.0,1.0,,7.0,1.54,,,0.55,paypal,8.54,0.0,1018699286,,0.7,0.7,0.0,5.75,338.68,5.75,digital download,,http://mdoumoctar.bandcamp.com/album/ilana-the-creator,,SS-051,602318 136893,,Isaac Cummings,jeffreyreed@moore-medina.com,890-405-7108,,Ivan Ramirez,10252 Ronald Ridge Suite 117,,,,,,,,,Slovenia,SI,Obcina Ivancna Gorica,Ivančna Gorica,Bandcamp fan wishlist,bandcamp.com/app/android/wishlist
728,1/29/20 10:57pm,Bandcamp,album,Anar,Mdou Moctar,USD,7.0,1.0,,7.0,1.4,,,0.57,credit card,8.4,0.0,892301782,,0.7,0.7,0.0,5.73,344.41,5.73,digital download,,http://mdoumoctar.bandcamp.com/album/anar,,SS-024,889326 664857,,Shelia Brooks,thomashatfield@yahoo.com,9869666796,,Dalton Gibbs,41193 Nelson Knoll Suite 577,,,,,,,,,France,FR,Loire-Atlantique,Vertou,sahelsounds.com (embedded player),sahelsounds.com/artists/mdou-moctar/
729,1/30/20 2:41am,Bandcamp,album,Ilana: The Creator,Mdou Moctar,USD,7.0,1.0,,7.0,,,,0.4,paypal,7.0,0.0,1369739283,,0.7,0.7,0.0,5.9,350.31,5.9,digital download,,http://mdoumoctar.bandcamp.com/album/ilana-the-creator,,SS-051,602318 136893,,Deborah Holland,kevindavila@olson-frazier.com,(665)188-9593x17204,,Daniel Johnson,35213 Medina Ridge,,,,,,,,,United States,US,NY,Corning,Bandcamp home page,bandcamp.com/
730,1/30/20 3:28am,Bandcamp,album,Ilana: The Creator,Mdou Moctar,USD,7.0,1.0,,7.0,,,,0.4,credit card,7.0,0.0,2250070940,,0.7,0.7,0.0,5.9,356.21,5.9,digital download,,http://mdoumoctar.bandcamp.com/album/ilana-the-creator,,SS-051,602318 136893,,Wendy Ballard,fchen@hotmail.com,910-538-6360x9525,,Natasha Gutierrez,896 Lori Forges,,,,,,,,,United States,US,NY,Brooklyn,Bandcamp search,bandcamp.com/app/ios/search
731,1/30/20 5:15am,Bandcamp,album,Music from Saharan WhatsApp,Etran de L'Aïr,USD,3.0,1.0,,3.0,,,,0.2,paypal,3.0,0.0,1967589057,,0.3,0.3,0.0,2.5,358.71,2.5,digital download,,http://etrandelair.bandcamp.com/album/music-from-saharan-whatsapp,,WHATSAPP-01,,,Lori Meyers,mcknightbrent@nolan.com,343-564-6064x653,,Johnny Collins,5771 Jennifer Lodge,,,,,,,,,United States,US,DC,Washington,,
732,1/30/20 5:17am,Bandcamp,package,No. 1,Etran de L'Aïr,USD,17.0,1.0,,17.0,,5.0,United States,0.72,paypal,22.0,0.0,3130670178,,1.7,1.7,0.0,19.58,378.29,14.58,Limited Edition LP,,http://etrandelair.bandcamp.com/album/no-1,SS-045lp,SS-045,602318 136824,,Christina Ewing,qcoffey@gmail.com,398.370.4383,,Carol Smith,91068 Tina Lane Suite 177,,Fort Myers,FL,33912-1704,United States,US,2/4/20,,United States,US,FL,Fort Myers,Bandcamp fan wishlist,bandcamp.com/jo_dem
733,1/30/20 5:19am,Bandcamp,album,Les Filles de Illighadad,Les Filles de Illighadad,USD,10.0,1.0,,10.0,,,,0.49,paypal,10.0,0.0,379944373,,1.0,1.0,0.0,8.51,386.8,8.51,digital download,,http://lesfillesdeillighadad.bandcamp.com/album/les-filles-de-illighadad,,SS-033,889326 664918,,Jonathan Cobb,karahamilton@gmail.com,(223)328-8658x4873,,Michael Weber,8307 Smith Course Suite 623,,,,,,,,,United States,US,CA,Chico,,
734,1/30/20 10:33am,Bandcamp,album,Music from Saharan WhatsApp,Etran de L'Aïr,USD,5.0,1.0,,5.0,,,,0.35,paypal,5.0,0.0,2804766045,,0.5,0.5,0.0,4.15,390.95,4.15,digital download,,http://etrandelair.bandcamp.com/album/music-from-saharan-whatsapp,,WHATSAPP-01,,,Melissa Lang,powellcrystal@gmail.com,606.390.0240x84491,,Jennifer Jimenez,63125 Gerald Crossing,,,,,,,,,Ireland,IE,Leinster,Dublin,Bandcamp search: “sahel sounds”,bandcamp.com/search?q=sahel%20sounds
735,1/30/20 10:34am,Bandcamp,package,Ilana: The Creator,Mdou Moctar,USD,17.0,1.0,,17.0,,4.0,United States,3.05,credit card,21.0,0.0,2247635282,,1.7,0.0,1.7,0.0,390.95,12.25,Ilana LP,,http://mdoumoctar.bandcamp.com/album/ilana-the-creator,SS-051lp,SS-051,602318 136893,,John Moon,philipmcmillan@hotmail.com,345.104.0726,,James Allen,2469 Lopez Street Apt. 669,,Barcelona,Barcelona,8007,Spain,ES,2/4/20,,Spain,ES,Barcelona,Barcelona,,
736,1/30/20 10:34am,Bandcamp,package,Fasokan,Luka Productions,USD,17.0,1.0,,17.0,,7.0,United States,,,24.0,0.0,2247635282,,1.7,0.0,3.4,0.0,390.95,15.3,Fasokan LP,,http://lukaproductions.bandcamp.com/album/fasokan,SS-040lp,SS-040,889326 900344,,John Moon,dalejackson@nixon.com,775-516-0320x321,,Wanda Goodwin,9629 Lori Plains,,Barcelona,Barcelona,8007,Spain,ES,2/4/20,,Spain,ES,Barcelona,Barcelona,,
737,1/30/20 10:34am,Bandcamp,package,Eghass Malan,Les Filles de Illighadad,USD,17.0,1.0,,17.0,,24.0,United States,,,41.0,0.0,2247635282,,1.7,5.1,0.0,77.85,468.8,15.3,'Eghass Malan' LP,,http://lesfillesdeillighadad.bandcamp.com/album/eghass-malan,SS-044lp-1,SS-044,191515 928351,,John Moon,jacklopez@yahoo.com,538-347-1099,,Stephen Tapia,772 Williams Highway Apt. 184,,Barcelona,Barcelona,8007,Spain,ES,2/4/20,,Spain,ES,Barcelona,Barcelona,,
738,1/30/20 2:07pm,Bandcamp,album,Music from Saharan WhatsApp,Etran de L'Aïr,USD,1.0,1.0,,1.0,,,,0.11,paypal,1.0,0.0,2616290170,,0.1,0.1,0.0,0.79,469.59,0.79,digital download,,http://etrandelair.bandcamp.com/album/music-from-saharan-whatsapp,,WHATSAPP-01,,,Dawn Gonzalez,kdavid@webb.net,001-216-326-4914,,Christopher Hines,2752 Chase Burgs,,,,,,,,,United Kingdom,GB,Plymouth,Plymouth,Bandcamp music feed,http://blog.bandcamp.com/2013/09/19/strap-on-your-feed-bag/
739,1/30/20 2:07pm,Bandcamp,package,Taaritt,Mamman Sani,USD,18.0,1.0,,18.0,,5.0,United States,0.74,paypal,23.0,0.0,3961196539,,1.8,1.8,0.0,20.46,490.05,15.46,Taaritt LP,,http://mammansani.bandcamp.com/album/taaritt,SS-023lp,SS-023,889326 664871,,Ryan Collins,laura74@benson-miller.com,(005)343-6946x37504,,Nathan Coleman,54867 Harris Spurs Apt. 824,,Oakwood,OH,45419,United States,US,2/4/20,,United States,US,OH,Oakwood,,
740,1/30/20 2:17pm,Bandcamp,album,Sahel Sounds Label Sampler,Various Artists,USD,1.0,1.0,,1.0,,,,0.11,paypal,1.0,0.0,2594428803,,0.1,0.1,0.0,0.79,490.84,0.79,digital download,,http://sahelsounds.bandcamp.com/album/sahel-sounds-label-sampler,,SS-058,602318 137111,,Sheila Mccormick,landrews@gmail.com,+1-464-408-4423,,Stephanie Oliver,27794 Kenneth Shore,,,,,,,,,Germany,DE,Baden-Württemberg,Karlsruhe,bandcamp.com,bandcamp.com
741,1/30/20 2:45pm,Bandcamp,album,Zerzura (Original Soundtrack Recording),Ahmoudou Madassane,USD,7.0,1.0,,7.0,1.47,,,0.55,paypal,8.47,0.0,159202689,,0.7,0.7,0.0,5.75,496.59,5.75,digital download,,http://ahmoudoumadassane.bandcamp.com/album/zerzura-original-soundtrack-recording,,SS-046,656605 382067,,John Wilson,imcintosh@mcdonald.biz,001-578-036-4185,,Nicole Coleman,52681 Megan Turnpike Apt. 060,,,,,,,,,Belgium,BE,Brussels Capital,Brussels,Google search,www.google.com/
742,1/30/20 3:07pm,Bandcamp,album,Uchronia – Field Recordings From Alternate Realities,Sahel Sounds,USD,5.0,1.0,,5.0,,,,0.35,credit card,5.0,0.0,3781870504,,0.5,0.5,0.0,4.15,500.74,4.15,digital download,,http://sahelsounds.bandcamp.com/album/uchronia-field-recordings-from-alternate-realities,,SS-000,,,Vanessa Bright,kathleen59@gmail.com,739-728-7639,,Scott Willis,684 Patrick Square,,,,,,,,,France,FR,Paris,Paris,Bandcamp fan page: fibreglass,bandcamp.com/fibreglass
743,1/30/20 6:02pm,shop@sahelsounds.com,payout,,,USD,,,,,,,,2.21,transfer,220.96,218.75,t255018162,68Y836471S035380D,,,,-220.96,279.78,,,,,,,,,,,,,,,,,,,,,,,,,,,,
744,1/30/20 6:02pm,shop@sahelsounds.com,payout,,,USD,,,,,,,,0.99,transfer,99.4,98.41,t255018161,40G89306J40385549,,,,-99.4,180.38,,,,,,,,,,,,,,,,,,,,,,,,,,,,
745,1/30/20 6:05pm,Bandcamp,album,Kani,Pheno S.,USD,7.0,1.0,,7.0,,,,1.2,credit card,7.0,0.0,865361915,,0.7,0.0,0.7,0.0,180.38,5.1,digital download,,http://phenos.bandcamp.com/album/kani,,SS-019,889326 667650,,Rachel Smith,zhenry@hotmail.com,001-494-360-4835,,Sylvia Lee,73288 Martin Crossing Suite 254,,,,,,,,,Lebanon,LB,Beyrouth,Beirut,Publish notice sent to your fans,
746,1/30/20 6:05pm,Bandcamp,album,Top WZN,Jeich Ould Badu and Ahmedou Ahmed Lewla,USD,7.0,1.0,,7.0,,,,,,7.0,0.0,865361915,,0.7,0.0,1.4,0.0,180.38,6.3,digital download,,http://topwzn.bandcamp.com/album/top-wzn,,SS-039,889326 860648,,Rachel Smith,gsullivan@yahoo.com,133-698-1138x655,,Lisa Farley,85685 Dave View,,,,,,,,,Lebanon,LB,Beyrouth,Beirut,Publish notice sent to your fans,
747,1/30/20 6:05pm,Bandcamp,album,Houmeissa,Hama,USD,7.0,1.0,,7.0,,,,,,7.0,0.0,865361915,,0.7,0.0,2.1,0.0,180.38,6.3,digital download,,http://hamasynth.bandcamp.com/album/houmeissa,,SS-049,656605 382364,,Rachel Smith,matthewrobinson@hotmail.com,114-251-1876x4385,,Donald Nguyen,5889 Perez Lock,,,,,,,,,Lebanon,LB,Beyrouth,Beirut,Publish notice sent to your fans,
748,1/30/20 6:05pm,Bandcamp,album,Balani Show Super Hits: Electronic Street Parties from Mali,Various,USD,7.0,1.0,,7.0,,,,,,7.0,0.0,865361915,,0.7,2.8,0.0,24.0,204.38,6.3,digital download,,http://sahelsounds.bandcamp.com/album/balani-show-super-hits-electronic-street-parties-from-mali,,SS-021,889326 667643,,Rachel Smith,ronald53@yahoo.com,(977)906-1138x74778,,Jacqueline Washington,392 Jeffrey Passage,,,,,,,,,Lebanon,LB,Beyrouth,Beirut,Publish notice sent to your fans,
749,1/30/20 8:02pm,Bandcamp,album,Music from Saharan WhatsApp,Etran de L'Aïr,USD,6.0,1.0,,6.0,,,,0.35,paypal,6.0,0.0,365406215,,0.6,0.6,0.0,5.05,209.43,5.05,digital download,,http://etrandelair.bandcamp.com/album/music-from-saharan-whatsapp,,WHATSAPP-01,,,Sabrina Johnson,martinbenjamin@gmail.com,+1-537-963-2722x9087,,Allison Shields,901 Noah Ferry,,,,,,,,,United States,US,MA,Medford,Bandcamp search,bandcamp.com/autocomplete-search
750,1/30/20 8:28pm,Bandcamp,album,Music from Saharan WhatsApp,Etran de L'Aïr,USD,2.0,1.0,,2.0,,,,0.35,credit card,2.0,0.0,3430416138,,0.2,0.0,0.2,0.0,209.43,1.45,digital download,,http://etrandelair.bandcamp.com/album/music-from-saharan-whatsapp,,WHATSAPP-01,,,Billy Ramos,natalie19@yahoo.com,471.310.6954,,Joseph Mcgee,553 Johnny Burg Suite 138,,,,,,,,,Poland,PL,Lesser Poland,Krakow,Bandcamp fan activity email,bandcamp.com
751,1/30/20 8:28pm,Bandcamp,album,Sahel Sounds Label Sampler,Various Artists,USD,3.0,1.0,,3.0,,,,,,3.0,0.0,3430416138,,0.3,0.5,0.0,4.15,213.58,2.7,digital download,,http://sahelsounds.bandcamp.com/album/sahel-sounds-label-sampler,,SS-058,602318 137111,,Billy Ramos,lewisstephen@rodriguez-holmes.com,782.049.9092x0412,,Michelle Cooper,1244 Susan Stream Suite 210,,,,,,,,,Poland,PL,Lesser Poland,Krakow,Recommendations footer: artist recommendation,bandcamp.com/footer/ar/a466185704
752,1/30/20 8:51pm,Bandcamp,album,Music from Saharan WhatsApp,Etran de L'Aïr,USD,6.0,1.0,,6.0,,,,0.41,paypal,6.0,0.0,4180304330,,0.6,0.6,0.0,4.99,218.57,4.99,digital download,,http://etrandelair.bandcamp.com/album/music-from-saharan-whatsapp,,WHATSAPP-01,,,Timothy Tran,erica12@villa.com,+1-783-305-5671x798,,Jonathan Smith,59562 Samuel Isle,,,,,,,,,United Kingdom,GB,Highland,Muir of Ord,Bandcamp search,bandcamp.com/app/android/search
753,1/30/20 9:07pm,Bandcamp,package,Sahel Sounds Label Sampler,Various Artists,USD,20.0,1.0,,20.0,,5.0,United States,0.85,credit card,25.0,0.0,1528468073,,2.0,2.0,0.0,22.15,240.72,17.15,Sahel Sounds t-shirt,Small,http://sahelsounds.bandcamp.com/merch/sahel-sounds-t-shirt,SS-T01-BLK-USM,,,,Shelby Guzman,thomasalvarado@haley.net,864.369.5475,,Emily Allen,493 Brown Estates,,Oakland,CA,94605,United States,US,2/4/20,,United States,US,CA,Oakland,Google search,www.google.com/
754,1/30/20 9:08pm,Bandcamp,album,Les Filles de Illighadad,Les Filles de Illighadad,USD,7.0,1.0,,7.0,1.47,,,0.55,paypal,8.47,0.0,2525398065,,0.7,0.7,0.0,5.75,246.47,5.75,digital download,,http://lesfillesdeillighadad.bandcamp.com/album/les-filles-de-illighadad,,SS-033,889326 664918,,John Wilson,kelly92@barton-rodriguez.com,+1-024-665-4746,,Maria Graves,810 Morgan Meadows Suite 786,,,,,,,,,Belgium,BE,Brussels Capital,Brussels,Bandcamp fan wishlist,bandcamp.com/nicobxl
755,1/30/20 9:12pm,Bandcamp,album,Tiris,El Wali,USD,7.0,1.0,,7.0,,,,0.4,credit card,7.0,0.0,620106106,,0.7,0.7,0.0,5.9,252.37,5.9,digital download,,http://elwali.bandcamp.com/album/tiris,,SS-055,602318 136923,,Travis Gordon,smithjohn@gmail.com,7826013153,,Sherry Stark,54989 Whitehead Way Suite 521,,,,,,,,,United States,US,CA,Los Angeles,Bandcamp search,bandcamp.com/autocomplete-search
756,1/31/20 2:11am,Bandcamp,album,Music from Saharan WhatsApp,Etran de L'Aïr,USD,2.0,1.0,,2.0,,,,0.15,credit card,2.0,0.0,1396144263,,0.2,0.2,0.0,1.65,254.02,1.65,digital download,,http://etrandelair.bandcamp.com/album/music-from-saharan-whatsapp,,WHATSAPP-01,,,Dustin Blankenship,ythomas@gmail.com,(398)479-5658x03850,,Joanne Ramos,906 George Tunnel,,,,,,,,,Argentina,AR,Buenos Aires F.D.,Buenos Aires,Bandcamp New & Notable,bandcamp.com/#new-notable
757,1/31/20 3:03am,Bandcamp,album,Music from Saharan WhatsApp,Etran de L'Aïr,USD,3.0,1.0,,3.0,,,,0.2,paypal,3.0,0.0,3720662783,,0.3,0.3,0.0,2.5,256.52,2.5,digital download,,http://etrandelair.bandcamp.com/album/music-from-saharan-whatsapp,,WHATSAPP-01,,,Courtney Lowe,uschmitt@carter-webb.biz,(159)176-1889x8760,,Jessica Richards,065 Kevin Loaf,,,,,,,,,United States,US,PA,Philadelphia,youtube.com,www.youtube.com/
758,1/31/20 3:18am,Bandcamp,album,Music from Saharan WhatsApp,Etran de L'Aïr,USD,5.0,1.0,,5.0,,,,0.35,paypal,5.0,0.0,3820060667,,0.5,0.5,0.0,4.15,260.67,4.15,digital download,,http://etrandelair.bandcamp.com/album/music-from-saharan-whatsapp,,WHATSAPP-01,,,Jodi Chen,renee35@hotmail.com,451.601.3959x485,,Rebecca Kemp,05630 Hogan Glen,,,,,,,,,United States,US,AZ,Tucson,,
759,1/31/20 3:31am,Bandcamp,album,La Musique Electronique du Niger,Mamman Sani,USD,7.0,1.0,,7.0,,,,0.4,paypal,7.0,0.0,1488679027,,0.7,0.7,0.0,5.9,266.57,5.9,digital download,,http://mammansani.bandcamp.com/album/la-musique-electronique-du-niger,,SS-011,889326 664864,,Malik Scott,thomasthomas@gmail.com,+1-250-187-8188x03909,,Brian Harrison,211 William Unions Apt. 692,,,,,,,,,United States,US,WI,Stevens Point,Bandcamp music feed,http://blog.bandcamp.com/2014/01/30/bandcamp-app-now-with-music-feed/
760,1/31/20 3:42am,Bandcamp,package,Tiris,El Wali,USD,17.0,1.0,,17.0,,5.0,United States,1.08,paypal,22.0,0.0,2184213432,,1.7,0.0,1.7,0.0,266.57,14.22,Tiris LP,,http://elwali.bandcamp.com/album/tiris,SS-055lp,SS-055,602318 136923,,Kristen Matthews,wellsjason@gmail.com,566.717.7649x46597,,David Patel,6322 Dawson Wall Apt. 910,3801 Electric Rd.,Roanoke,VA,24018,United States,US,2/4/20,,United States,US,VA,Roanoke,Bandcamp search,bandcamp.com/app/android/search
761,1/31/20 3:42am,Bandcamp,package,Anou Malane,Abdallah Ag Oumbadougou,USD,17.0,1.0,,17.0,,2.0,United States,,,19.0,0.0,2184213432,,1.7,3.4,0.0,36.52,303.09,15.3,Vinyl,,http://abdallahagoumbadougou.bandcamp.com/album/anou-malane,SS-053lp,SS-053,602318 136992,,Kristen Matthews,brett22@french.com,4216170974,,Cristina Thomas,98191 Mike Tunnel Suite 350,3801 Electric Rd.,Roanoke,VA,24018,United States,US,2/4/20,,United States,US,VA,Roanoke,Bandcamp search,bandcamp.com/app/android/search
762,1/31/20 5:38am,Bandcamp,album,Balani Show Super Hits: Electronic Street Parties from Mali,Various,USD,7.0,1.0,,7.0,,,,0.4,paypal,7.0,0.0,1534065396,,0.7,0.7,0.0,5.9,308.99,5.9,digital download,,http://sahelsounds.bandcamp.com/album/balani-show-super-hits-electronic-street-parties-from-mali,,SS-021,889326 667643,,Patricia Davis,meganshaw@lyons-brown.com,597-880-6673x63403,,David Martinez,689 Robert Forks Apt. 628,,,,,,,,,Japan,JP,Tokyo,Tokyo,,
763,1/31/20 6:15am,Bandcamp,album,Ilana: The Creator,Mdou Moctar,USD,7.0,1.0,,7.0,,,,0.47,paypal,7.0,0.0,2760704843,,0.7,0.7,0.0,5.83,314.82,5.83,digital download,,http://mdoumoctar.bandcamp.com/album/ilana-the-creator,,SS-051,602318 136893,,Christopher Spencer,castroanthony@edwards.org,(615)165-6054x6344,,Anthony Olson,240 Garcia Trace,,,,,,,,,Australia,AU,VIC,Balwyn North,Google search,www.google.com.au/
764,1/31/20 9:50am,Bandcamp,package,Akounak Tedalat Taha Tazoughai OST,Mdou Moctar,USD,17.0,1.0,,17.0,,4.0,United States,5.74,credit card,21.0,0.0,1629679578,,1.7,0.0,1.7,0.0,314.82,9.56,Akounak OST LP,,http://mdoumoctar.bandcamp.com/album/akounak-tedalat-taha-tazoughai-ost,SS-028lp-1,SS-028,889326 667599,,Kenneth Cummings,russelljeffrey@gmail.com,4286671019,,Harry Henderson,84728 Nelson Village,,Skopje,mkd,1020,Serbia,RS,2/4/20,,Serbia,RS,mkd,Skopje,,
765,1/31/20 9:50am,Bandcamp,package,Anou Malane,Abdallah Ag Oumbadougou,USD,17.0,1.0,,17.0,,4.0,United States,,,21.0,0.0,1629679578,,1.7,0.0,3.4,0.0,314.82,15.3,Vinyl,,http://abdallahagoumbadougou.bandcamp.com/album/anou-malane,SS-053lp,SS-053,602318 136992,,Kenneth Cummings,robertsonjames@gmail.com,205-506-1838x56065,,Cassandra Wise,972 Janet Estates Apt. 525,,Skopje,mkd,1020,Serbia,RS,2/4/20,,Serbia,RS,mkd,Skopje,,
766,1/31/20 9:50am,Bandcamp,package,No. 1,Etran de L'Aïr,USD,17.0,1.0,,17.0,,4.0,United States,,,21.0,0.0,1629679578,,1.7,0.0,5.1,0.0,314.82,15.3,Limited Edition LP,,http://etrandelair.bandcamp.com/album/no-1,SS-045lp,SS-045,602318 136824,,Kenneth Cummings,robertlester@gmail.com,414-891-7633,,Peter Little,4375 Russell Stravenue Suite 282,,Skopje,mkd,1020,Serbia,RS,2/4/20,,Serbia,RS,mkd,Skopje,,
767,1/31/20 9:50am,Bandcamp,package,Music from Saharan Cellphones: Volume 2,Various,USD,17.0,1.0,,17.0,,24.0,United States,,,41.0,0.0,1629679578,,1.7,0.0,6.8,0.0,314.82,15.3,Vinyl Edition of Music from Saharan Cellphones Volume 2,,http://sahelsounds.bandcamp.com/album/music-from-saharan-cellphones-volume-2,SS-012lp,SS-012,889326 667742,,Kenneth Cummings,fjones@yahoo.com,545.912.3268,,Felicia Jenkins,065 Lewis Circle,,Skopje,mkd,1020,Serbia,RS,2/4/20,,Serbia,RS,mkd,Skopje,,
768,1/31/20 9:50am,Bandcamp,package,Eghass Malan,Les Filles de Illighadad,USD,17.0,1.0,,17.0,,4.0,United States,,,21.0,0.0,1629679578,,1.7,0.0,8.5,0.0,314.82,15.3,'Eghass Malan' LP,,http://lesfillesdeillighadad.bandcamp.com/album/eghass-malan,SS-044lp-1,SS-044,191515 928351,,Kenneth Cummings,hectorhunt@gmail.com,001-103-694-7255x252,,Brittany Brown,50106 Chapman Parkways Suite 020,,Skopje,mkd,1020,Serbia,RS,2/4/20,,Serbia,RS,mkd,Skopje,,
769,1/31/20 9:50am,Bandcamp,package,Les Filles de Illighadad,Les Filles de Illighadad,USD,17.0,1.0,,17.0,,4.0,United States,,,21.0,0.0,1629679578,,1.7,0.0,10.2,0.0,314.82,15.3,Les Filles de Illighadad LP,,http://lesfillesdeillighadad.bandcamp.com/album/les-filles-de-illighadad,SS-033-LP,SS-033,889326 664918,,Kenneth Cummings,adrian37@barnes-perez.org,001-127-137-8518x8529,,Jessica Wright,12696 Thomas Run,,Skopje,mkd,1020,Serbia,RS,2/4/20,,Serbia,RS,mkd,Skopje,,
770,1/31/20 9:50am,Bandcamp,package,Taaritt,Mamman Sani,USD,17.0,1.0,,17.0,,7.0,United States,,,24.0,0.0,1629679578,,1.7,11.9,0.0,152.36,467.18,15.3,Taaritt LP,,http://mammansani.bandcamp.com/album/taaritt,SS-023lp,SS-023,889326 664871,,Kenneth Cummings,shawnthompson@jones-burnett.com,805.073.0704,,Sandra Lucero,8401 Cortez Center Apt. 075,,Skopje,mkd,1020,Serbia,RS,2/4/20,,Serbia,RS,mkd,Skopje,,
771,1/31/20 11:11am,Bandcamp,album,Music from Saharan WhatsApp,Etran de L'Aïr,USD,1.0,1.0,,1.0,,,,0.11,paypal,1.0,0.0,27471294,,0.1,0.1,0.0,0.79,467.97,0.79,digital download,,http://etrandelair.bandcamp.com/album/music-from-saharan-whatsapp,,WHATSAPP-01,,,Jeremy Roberts,jensenmeredith@hotmail.com,905.693.5478x724,,Tiffany Kelly,45222 Chelsey Union,,,,,,,,,United Kingdom,GB,England,London,Bandcamp music feed,http://blog.bandcamp.com/2014/01/30/bandcamp-app-now-with-music-feed/
772,1/31/20 1:22pm,Bandcamp,album,Tiris,El Wali,USD,8.0,1.0,,8.0,,,,0.45,paypal,8.0,0.0,1321099662,,0.8,0.8,0.0,6.75,474.72,6.75,digital download,,http://elwali.bandcamp.com/album/tiris,,SS-055,602318 136923,,Candace Tate,hardynicole@gmail.com,+1-842-311-3407,,Samuel Gonzalez,2321 Garza Motorway,,,,,,,,,United States,US,NJ,Montclair,Bandcamp search,bandcamp.com/autocomplete-search
773,1/31/20 1:27pm,Bandcamp,album,Sousoume Tamachek,Mdou Moctar,USD,8.0,1.0,,8.0,,,,0.45,paypal,8.0,0.0,1472558114,,0.8,0.8,0.0,6.75,481.47,6.75,digital download,,http://mdoumoctar.bandcamp.com/album/sousoume-tamachek,,SS-043,191515 769435,,Candace Tate,donald87@hotmail.com,715-246-7616x50160,,Bradley Moore,0626 Annette Hollow,,,,,,,,,United States,US,NJ,Montclair,Bandcamp search,bandcamp.com/autocomplete-search
774,1/31/20 1:33pm,Bandcamp,album,Music from Saharan WhatsApp,Etran de L'Aïr,USD,3.0,1.0,,3.0,,,,0.23,paypal,3.0,0.0,56578963,,0.3,0.3,0.0,2.47,483.94,2.47,digital download,,http://etrandelair.bandcamp.com/album/music-from-saharan-whatsapp,,WHATSAPP-01,,,Chad Silva,rebekah59@russell.com,001-481-950-5846x643,,Timothy Boyd,1713 Randy Valley Apt. 705,,,,,,,,,United Kingdom,GB,,,,
775,1/31/20 3:12pm,Bandcamp,album,Music from Saharan WhatsApp,Etran de L'Aïr,USD,3.0,1.0,,3.0,,,,0.2,credit card,3.0,0.0,3847096334,,0.3,0.3,0.0,2.5,486.44,2.5,digital download,,http://etrandelair.bandcamp.com/album/music-from-saharan-whatsapp,,WHATSAPP-01,,,Thomas Mccormick,erik31@gmail.com,(336)152-9421x14817,,Jason Schneider,1124 Perry Pines Suite 587,,,,,,,,,Netherlands,NL,North Holland,Amsterdam,lesateliersclaus.com (embedded player),www.lesateliersclaus.com/
776,1/31/20 4:53pm,Bandcamp,album,Fasokan,Luka Productions,USD,10.0,1.0,,10.0,1.4,,,0.63,paypal,11.4,0.0,1933022768,,1.0,1.0,0.0,8.37,494.81,8.37,digital download,,http://lukaproductions.bandcamp.com/album/fasokan,,SS-040,889326 900344,,Cheryl Williams,rosseric@hotmail.com,7371018250,,Bryan Harper,596 Ortiz Flats Suite 917,,,,,,,,,United Kingdom,GB,Southwark,Dulwich,,
777,1/31/20 5:04pm,Bandcamp,album,Music from Saharan WhatsApp,Etran de L'Aïr,USD,3.0,1.0,,3.0,,,,0.23,credit card,3.0,0.0,1702413905,,0.3,0.3,0.0,2.47,497.28,2.47,digital download,,http://etrandelair.bandcamp.com/album/music-from-saharan-whatsapp,,WHATSAPP-01,,,Paula Lewis,uramirez@gmail.com,+1-019-550-9440x7389,,Jade Dillon,071 Baker Pine,,,,,,,,,United Kingdom,GB,Islington,Finsbury,Bandcamp search,bandcamp.com/autocomplete-search
778,1/31/20 5:14pm,Bandcamp,package,Sahel Sounds Label Sampler,Various Artists,USD,20.0,1.0,,20.0,,15.0,United States,1.32,paypal,35.0,0.0,1163640221,,2.0,2.0,0.0,31.68,528.96,16.68,Sahel Sounds t-shirt,Medium,http://sahelsounds.bandcamp.com/merch/sahel-sounds-t-shirt,SS-T01-BLK-UMD,,,,Brandon Cox,stevensonjamie@kaiser.info,5468294510,,David Perez,0504 Kristin Plaza Suite 594,,Kiiminki,Oulun lääni,90900,Finland,FI,2/4/20,,Finland,FI,Oulun lääni,Kiiminki,Google search,www.google.fi/
779,1/31/20 5:56pm,Bandcamp,album,Ilana: The Creator,Mdou Moctar,USD,7.0,1.0,,7.0,,,,0.4,paypal,7.0,0.0,633526598,,0.7,0.7,0.0,5.9,534.86,5.9,digital download,,http://mdoumoctar.bandcamp.com/album/ilana-the-creator,,SS-051,602318 136893,,Christine Delacruz,erin47@robinson.com,001-222-365-4380,,Natasha Meadows,330 Jason Loop,,,,,,,,,United States,US,NC,Raleigh,Bandcamp fan page: neilicus10,bandcamp.com/neilicus10/wishlist
780,1/31/20 6:03pm,shop@sahelsounds.com,payout,,,USD,,,,,,,,1.44,transfer,143.63,142.19,t255296962,16S15196P5223831C,,,,-143.63,391.23,,,,,,,,,,,,,,,,,,,,,,,,,,,,
781,1/31/20 6:03pm,shop@sahelsounds.com,payout,,,USD,,,,,,,,0.37,transfer,36.75,36.38,t255296963,8CS77122CD873264T,,,,-36.75,354.48,,,,,,,,,,,,,,,,,,,,,,,,,,,,
782,1/31/20 6:47pm,Bandcamp,package,Sahel Sounds Label Sampler,Various Artists,USD,20.0,1.0,,20.0,,15.0,United States,1.42,credit card,35.0,0.0,847461411,,2.0,2.0,0.0,31.58,386.06,16.58,Sahel Sounds t-shirt,XXL,http://sahelsounds.bandcamp.com/merch/sahel-sounds-t-shirt,SS-T01-BLK-UXXL,,,,Anthony Thompson,smithpatricia@gmail.com,9123216882,,Nathan Watts,214 Miller Meadow,,Madrid,Madrid,28224,Spain,ES,2/4/20,,Spain,ES,Madrid,Madrid,l.instagram.com,l.instagram.com/?u=https%3A%2F%2Fsahelsounds.bandcamp.com%2Falbum%2Fbalani-show-super-hits-electronic-street-parties-from-mali&e=ATMZ4XNl1lVJcVUhpL58ov--VwiFWP9M0cuLaEEEnqnjloQEoIq-LnUMO-8pjM_lOh-WEn6iUk_r1x4
783,1/31/20 6:59pm,Bandcamp,package,Sahel Sounds Label Sampler,Various Artists,USD,20.0,1.0,,20.0,,5.0,United States,0.85,credit card,25.0,0.0,2131353211,,2.0,2.0,0.0,22.15,408.21,17.15,Record Tote Bag with Space Camel,,http://sahelsounds.bandcamp.com/merch/record-tote-bag-with-space-camel,SS-tote,,,,Andrew Hood,brendagreen@mason-griffin.com,(754)716-4820,,Brandon Thompson,85629 Mcconnell Divide Suite 556,,Azusa,CA,91702,United States,US,2/4/20,,United States,US,CA,Azusa,Google search,www.google.com/
784,1/31/20 7:35pm,Bandcamp,album,Music from Saharan WhatsApp,Etran de L'Aïr,USD,5.52,1.0,,5.52,,,,0.38,paypal,5.52,0.0,3538859488,,0.55,0.55,0.0,4.59,412.8,4.59,digital download,,http://etrandelair.bandcamp.com/album/music-from-saharan-whatsapp,,WHATSAPP-01,,,Brian Gray,wrightjames@hotmail.com,(490)988-8145x413,"Thank you for your beautiful music, love from Amsterdam (Netherlands)!!",Julia Bauer,318 Raymond Circle Apt. 451,,,,,,,,,Netherlands,NL,North Holland,Amsterdam,,
785,1/31/20 7:44pm,Bandcamp,album,Tiris,El Wali,USD,7.0,1.0,,7.0,,,,0.4,credit card,7.0,0.0,268303281,,0.7,0.7,0.0,5.9,418.7,5.9,digital download,,http://elwali.bandcamp.com/album/tiris,,SS-055,602318 136923,,Maurice Wilson,keith16@wilson-freeman.com,607-541-0713,,Charles Patterson,86924 Johnson Wall,,,,,,,,,United States,US,CA,Oakland,Bandcamp app fan collection: barbapop,bandcamp.com/barbapop
786,1/31/20 8:29pm,Bandcamp,album,Music from Saharan WhatsApp,Etran de L'Aïr,USD,15.0,1.0,,15.0,,,,0.74,paypal,15.0,0.0,2208486249,,1.5,1.5,0.0,12.76,431.46,12.76,digital download,,http://etrandelair.bandcamp.com/album/music-from-saharan-whatsapp,,WHATSAPP-01,,,Benjamin Rodriguez,smithlauren@foster.com,442-419-5623x45483,,John Gaines,175 Grant Drive,,,,,,,,,Austria,AT,Salzburg,Salzburg,Bandcamp weekly newsletter,bandcamp.com
787,1/31/20 9:09pm,Bandcamp,album,Music from Saharan WhatsApp,Etran de L'Aïr,USD,6.0,1.0,,6.0,,,,0.41,paypal,6.0,0.0,2056957326,,0.6,0.6,0.0,4.99,436.45,4.99,digital download,,http://etrandelair.bandcamp.com/album/music-from-saharan-whatsapp,,WHATSAPP-01,,,Grace Roberts,joseph08@yahoo.com,001-856-415-8396,,Lee Webb,071 Cruz Stravenue,,,,,,,,,Ireland,IE,Leinster,Dublin,,
788,1/31/20 9:57pm,Bandcamp,album,Music from Saharan WhatsApp,Etran de L'Aïr,USD,3.0,1.0,,3.0,,,,0.23,credit card,3.0,0.0,3237236233,,0.3,0.3,0.0,2.47,438.92,2.47,digital download,,http://etrandelair.bandcamp.com/album/music-from-saharan-whatsapp,,WHATSAPP-01,,,Rachel Shannon,jenniferhicks@hotmail.com,001-474-018-8984x095,,Mary James,893 Jessica Estate,,,,,,,,,United Kingdom,GB,Croydon,Croydon,,
789,1/31/20 10:23pm,Bandcamp,album,Ilana: The Creator,Mdou Moctar,USD,7.0,1.0,,7.0,,,,0.47,credit card,7.0,0.0,1507275757,,0.7,0.7,0.0,5.83,444.75,5.83,digital download,,http://mdoumoctar.bandcamp.com/album/ilana-the-creator,,SS-051,602318 136893,,Megan Harvey,christina95@may.net,890-864-3794x013,,Christopher Nguyen,0016 Flores Knoll,,,,,,,,,Canada,CA,ON,Toronto,Bandcamp search: “mdou moctar”,bandcamp.com/search?q=Mdou%20Moctar
790,1/31/20 11:32pm,Bandcamp,album,Field Recordings from the Sahel,Sahel Sounds,USD,1.0,1.0,,1.0,,,,0.6,credit card,1.0,0.0,424511416,,0.1,0.0,0.1,0.0,444.75,0.3,digital download,,http://sahelsounds.bandcamp.com/album/field-recordings-from-the-sahel,,SS-057,602318 137104,,Emily Morales,stacey20@terry.biz,+1-696-684-2443x7008,,Beth Stout,01853 Tracy Light,,,,,,,,,Netherlands,NL,North Holland,Amsterdam,,
791,1/31/20 11:32pm,Bandcamp,album,Eghass Malan,Les Filles de Illighadad,USD,7.0,1.0,,7.0,1.47,,,,,8.47,0.0,424511416,,0.7,0.8,0.0,6.6,451.35,6.3,digital download,,http://lesfillesdeillighadad.bandcamp.com/album/eghass-malan,,SS-044,191515 928351,,Emily Morales,clarklaura@gmail.com,(110)718-0945,,Kaitlin Hill,57300 Martha Ferry,,,,,,,,,Netherlands,NL,North Holland,Amsterdam,Recommendations footer: commonly collected,bandcamp.com/footer/cc/a2286673087
